Chave: BATER
Glosa: dar uma surra; sujeitar a uma surra, como punição ou como ato de agressão
Tipo Semantico: verb.contact
{
apalear: " Mandou apalear o inimigo.," 
aporrear: " Andava-se empandilhado, bem armado; podia-se às vezes dar um vareio nos milicos, ajustar contas com algum devedor de desaforos, aporrear algum subdelegado.," 
bater: " Ele bebia, batia em minha mãe, não parava em emprego nenhum.," 
coçar: " Os populares coçaram o assaltante.," 
desancar: " Desancaram a vítima e fugiram.," 
descadeirar: " Dois rapazinhos quiseram chegar ainda assim, mas Pedro Barqueiro descadeirou um e pôs as tripas de fora a outro" 
deslombar: " Nunes, que só esperava por aquilo, passou a mão na sapuva e encarnando na esposa o odiado maneta deslombou-a numa sova de consertar negro ladrão.," 
encostar: " Saiu-se mal da briga" 
esbordoar: " Fragoso apanhou os talos da palmeira e com êles esbordoou o animal.," 
espancar: " Um membro da Guarda Municipal espancou, ontem, às 15h45, na Cinelândia, no Centro do Rio, uma mendiga negra e grávida.," 
esquadrilhar: " Esquadrilhou o inimigo.," 
malhar: "  Malhou impiedosamente no menino.," 
maltratar: " Um grupo de jovens menores maltratou sadicamente, apedrejou e espancou até à morte o transexual brasileiro Gisberto, um sem-teto de 45 anos. ," 
marretar: " Para se defender, apanhou um pedaço de pau, marretou a cabeça de João e, sem esperar pelo resultado, fugiu do local.," 
rachar: " Violento, ameaçava rachar todo mundo.," 
sapecar: " Sapecou o ladrão.," 
sovar: " Bateu com sustância, sovou com fôlego, quebrou as carnes, moeu bem moído.," 
surrar: " Furioso como uma fera, o estancieiro surrou-o, surrou de relho a mais não poder.," 
tundar: " Tundar alguém.," 
zabumbar: " Foi preso, pois costumava zabumbar pelos bares.," 
zupar: " Zupar nos ladrões com um porrete.," 
zurzir: " Zurzia o filho impiedosamente.," 
}
Alinhamento
  ILI: 01356759
  Synset: beat1, beat_up1, work_over
  Glosa/Exemplo: give a beating to; subject to a beating, either as a punishment or as an act of aggression; "Thugs beat him up when he walked down the street late at night"; "The teacher used to beat the students" 
  Tipo Semantico: verb.contact

