Chave: ESCURECER
Glosa: tornar ou fazer mais escuro
Tipo Semantico: verb.perception
{
assombrar: " Estava junto da torrente, preso nos ramos de uma azinheira gigantesca que assombrava o rio.," 
assombrear: " O fino buço começou a assombrear-lhe o lábio superior e as faces. / O globo negro foi instalado no meio do palácio, com fontes a sua volta, e belas árvores a lhe assombrear.," 
eclipsar: " Densas nuvens procuram eclipsar a brilhante luz do sol. ," 
encobrir: " A névoa cinzenta que encobre vários bairros da cidade, desde a última segunda-feira, surpreendeu o carioca.," 
enegrecer: " Agora a fumaça cobre e enegrece o céu.," 
enfuscar: " nstantâneamente, uma chuva grossa caíu com ruído, enfuscando o dia ainda mais.," 
enlutar: " Imensa formação de nuvens enlutou o céu.," 
enoitecer: " Olho para o céu e vejo a lua enoitecer aquilo que um dia foi claro.," 
ensombrar: " Na Regaleira os frondosos castanheiros continuam a ensombrar o mais lindo terraço que tem a serra.," 
ensombrecer: " O espaço [ensombrecia ao seu olhar. / A árvore frondosa ensombrece trechos da água com sua generosa ramagem.," 
entenebrecer: " Subia a fumaça que entenebrecia o sol.," 
entrevar2: " A noite entreva as florestas.," 
enturvar: " Havia couve por toda parte, enturvando a água.," 
escurecer: " A poeira levantada poderia escurecer o Sol.," 
escurentar: " O dia nublado escurentava aquele domingo.," 
obnubilar: " Nuvens pardacentas obnubilaram o sol. ," 
obscurecer: " Houve uma grande tempestade de poeira que obscureceu a superfície do planeta.," 
obumbrar: " Eram 11 horas do dia; uma trovoada estava iminente, que nublava o céu obumbrando os raios do sol.," 
ofuscar: " O excesso de luz e superfícies que refletem muito a claridade podem ofuscar a visão. ," 
sombrear: " Oito árvores sombreavam uma estátua que representava o faraó sentado. ," 
sombrejar: " Ao longe, sombrejando o horizonte, há uns arremedos de Capri, ilhas perdidas cujas corcovas montam por sobre a última linha do mar. ," 
toldar: " Poeira fina a toldar o sol. ," 
}
Alinhamento
  ILI: 02100237
  Synset: darken, dim
  Glosa/Exemplo: become or make darker; "The screen darkend"; "He darkened the colors by adding brown" 
  Tipo Semantico: verb.perception

