Chave: ESMIUÇAR
Glosa: olhar criticamente, de modo indagativo ou em mínimos detalhes
Tipo Semantico: verb.perception
{
apalpar: " As pesquisas estão apalpando o eleitorado.," 
aprofundar: " O Dr. Paulo Paim, que juntamente com o Dr. Oscar, lideram um segundo grupo que aprofundou o assunto em pauta.," 
correr: " Para confirmar suas pesquisas, correu todo o manuscrito.," 
descortinar: " Não é fácil descortinar-lhe o íntimo.," 
desfibrar: " Desfibrou as próprias sensações.," 
desmiuçar: " E mais uma vez me encantei com a sutileza (ou muitas vezes, a falta de) com que Sam Mendes desmiuçou todo o American Way of Life.," 
despiolhar: " Então, antes de salvar florestas dos parasitas da geração dos seus pais, tente despiolhar os armários em seu próprio quarto. ," 
devassar: " Manuel Bandeira devassou a intimidade feminina.," 
escarafunchar: " Serra escarafunchou meio mundo, aqui e alhures, região por região, por todo esse Brasil imenso, a fim de registrar vocábulos e expressões de que se valem.," 
escrutar: " O ilustre médico escrutava um texto de Averróis.," 
esmerilar: " Vou te compreendendo, somente de esmerilar em teu retrato.," 
esmerilhar: " O promotor esmerilhou uma circunstância do art. 192 para pedir a pena de morte.," 
esmiuçar: " Dantas esmiuçou a vida da população durante o período em que o Recife ficou sitiado pelos pernambucanos.," 
esmiudar: " O Código esmiudou a normação acerca do assunto, por meio do inciso , do art. 116.," 
espiolhar: " Poderíamos dizer que a ordem jurídica não pode deixar respiradouro ao frívolo curialismo, que se compraz em espiolhar inimidades ou privacidades.," 
esquadrinhar: " Esse é um dos principais retratos da pesquisa Datafolha que esquadrinhou as preferências do paulistano no futebol.," 
lustrar: " De helicóptero, o biólogo pôde lustrar toda a lagoa coberta de peixes mortos.," 
miudear: " Miudeou fatos passados.," 
palpitar: " Os institutos de pesquisa palpitaram as opiniões do eleitorado.," 
percorrer: " Rodavámos um script que percorria todos os arquivos de log do período selecionado.," 
perquirir: " Deve-se, portanto, perquirir cada caso isoladamente, dentro de sua fórmula inicial e de suas peculiaridades.," 
perscrutar: " O detetive perscrutou o suspeito com grande aplicação.," 
profundar: " Os pesquisadores devem se debruçar para profundar as discussões com o movimento.," 
rastejar: " Rastejou a causa de um crime.," 
recorrer: " Ao recorrer as últimas provas, ainda achou o revisor muitos erros.," 
sondar: " Você me observou, me sondou os sentimentos e me aconchegou no seu peito.," 
tentear1: " Antes de se decidir, tenteou o ânimo do adversário.," 
vasculhar: " Vasculhou arquivos de irmandades, igrejas, arquivos públicos, fez verdadeiro levantamento sobre a época.," 
}
Alinhamento
  ILI: 02091359
  Synset: size_up, take_stock, scrutinize, scrutinise
  Glosa/Exemplo: to look at critically or searchingly, or in minute detail; "he scrutinized his likeness in the mirror" 
  Tipo Semantico: verb.perception

