Chave: BRUXULEAR
Glosa: lampejar ou brilhar intermitentemente
Tipo Semantico: verb.perception
{
arder: " Sobre o sofá, destacava-se o vulto imóvel do cavalheiro, aos pés do qual ardia uma vela de cera, lançando pálidos clarões.," 
brilhar: " Em Rosselini e De Sica, por exemplo, mesmo quando se expõe a realidade mais sórdida, brilha a centelha do humano e às vezes do sagrado.," 
bruxulear: " O enfermo agonizava sempre; os soluços extremos da vida que se apaga como a lâmpada que bruxuleia, agitavam apenas o corpo enregelado.," 
centelhar: " Note o centelhando de Sirius e o esplendor fixo de Júpiter - confirmando que estrelas centelham e planetas não.," 
cintilar: " E os olhos de Isabel cintilaram.," 
esfuzilar: " Os relâmpagos esfuzilavam no céu.," 
estrelar: " Vejo sua sombra estrelando no meu pensamento.," 
fulgir: " Esses segundos fogem quando fulgem os olhos de Laura.," 
fulgurar: " A constelação pareceu confirmar este modo de sentir, fulgurando extraordinariamente.," 
fuzilar: " Os olhos do velho fuzilaram de raiva.," 
lucilar: " Lucilavam os astros embalando a noite de paz.," 
luciluzir: " Com a orvalhada noturna todo o almargem úmido luciluzia cintilantemente em brilhos diamantinos.," 
luzir: " Luziu límpida e brilhante a estrela-d’alva.," 
pestanejar: " Os olhos pestanejaram como se quisesse agradecer amavelmente essas gentilezas.," 
piscar: " AAs luzes do cenário de formas geométricas piscavam enquanto Diana saía de cena para suas trocas de roupa.," 
raiar1: " A Bíblia era então para mim um livro novo, considerava-a verdadeiramente um banquete para a razão; tudo que, em seus ensinos, fora ininteligível, místico ou obscuro para mim, dissipara-se-me do espírito ante a clara luz que ora raiava de suas páginas sagradas.," 
refulgir: " E as estrelas brilhantes refulgiam como raios.," 
relumbrar: " O seu olhar ardia e, em torno do seu corpo torreado, relumbrava um halo como se o emuldurassem chamas.," 
reluzir: " Reluziu uma estrela matinal.," 
tremeluzir: " A luz tremeluziu por um segundo.," 
tremer: " Lá longe, muito longe, as luzes tremiam, últimas luzes da Europa.," 
tremular: " Uma pequena luz tremulou em frente à carruagem." 
}
Alinhamento
  ILI: 02097924
  Synset: flash, blink, wink, twinkle, winkle
  Glosa/Exemplo: gleam or glow intermittently; "The lights were flashing" 
  Tipo Semantico: verb.perception

