ANÁLISE DA GLOSA3072b

DADO O SYNSET:

S='Glosa3072'
	    {
	      atroçoar: M]Atroçoar o milho.,
	      desbandalhar: x,
	      desfazer: Com auxilio do cortador de fórmica, comece a I]desfazer um pouco o torrão, desembaraçando as raízes conforme a última ilustração.,
	      despedaçar: Ergueu-se então, e sem mesmo dar-se ao trabalho de arrancar a seta, de um só movimento tomou à cinta as pistolas que tinha recebido de sua senhora, e [despedaçou a cabeça dos selvagens.,
	      destroçar: O corpo foi destroçado. ,
	      esbandalhar: x,
	      escacar: x,
	      escaqueirar: Pôs a luz no chão e meteu mãos à obra; se calhar, tinha que I]escaqueirar a tampa à martelada.,
	      escavacar: Mais pobres e menos esperançosos do que quando chegaram no garimpo, com o sonho da riqueza, não muito fácil porque I]escavacar o chão é tarefa árdua.,
	      esfazer: Reconta-me os feitos do herói astucioso que muito peregrinou, dês que I]esfez as muralhas sagradas de Tróia.,
	      espatifar: O impacto, a uma velocidade aproximada de 100 km/h, [espatifou os óculos e cortou o supercílio de Citolini, que trabalha para um jornal brasileiro na Califórnia.,
	      espedaçar: Em torno dos chefes lastravam o chão os tacapes e escudos que se tinham [espedaçado aos golpes de cada um.,
	      espostejar: Logo depois o dono da vítima e alguns ajudantes abrem o corpo e o I]espostejam com tal rapidez que não faria melhor um carniceiro de nossa terra ao esquartejar um carneiro.,
	      estilhaçar: Para melhorar o resultado, a superfície curva teria de ser [estilhaçada em milhares de polígonos de dimensões muito reduzidas.,
	      estilhar: A bomba I]estilhou um vidro, e explodiu 30 minutos após a retirada do policiamento, após uma vigilia de 24 horas.,
	      estrinçar: Ele I]estrinça lenha como um porco do monte.,
	      estroçar: x,
	      fragmentar: Os motoristas não sabem a diferença entre pára-brisa temperado, que [fragmenta em pedaços e laminado, que segundo o Instituto Nacional de Segurança no Trânsito, é de uso obrigatório por lei.,
	      hastilhar: x,
	      partir: Os tiros atravessaram o abdômen, I]partindo o estômago, o fígado e os rins de Elenir das Grassas de Azevedo, 41 anos.,
	      quebrar: Para serem utilizadas pelo organismo, são [quebradas em partículas menores durante a digestão.,
	    }

A ANÁLISE RESULTA EM:

S='Glosa3072b' = “tornar separado em peças ou fragmentos”
	     {partir: O joelho não agüentou, e o ligamento cruzado anterior (LCA) se I]partiu em dois.,
	      quebrar: Ele errou um dos golpes e [quebrou a vidraça de uma loja na esquina da rua Sá Ferreira.,}
Chave: QUEBRAR <verb.change>
ILI: 00323679

Sense 2
{00323679} <verb.change> break, separate3, split up, fall apart3, come apart -- (become separated into pieces or fragments; "The figurine broke"; "The freshly baked loaf fell apart")
       => {00135037} <verb.change> change integrity -- (change in physical make-up)
           => {00106479} <verb.change> change -- (undergo a change; become different in essence; losing one's or its original nature; "She changed completely as she grew older"; "The weather changed last night")
          Also See-> {00201816} <verb.change> break up2#18
