Chave: DESPERDIÇAR
Glosa: gastar frívolo e imprudentemente
Tipo Semantico: verb.consumption
{
abrasar: " O filho pródigo abrasou a herança paterna.," 
comer: " Há mais vida na vizinhança do nstituto Médico-Legal do que em volta do Triângulo das Bermudas, onde a Petrobrás, o BNDES e o falecido BNH comeram o patrimônio da viúva.," 
delapidar: " Júlio é um jogador de roleta inveterado que já delapidou quase toda a fortuna herdada dos pais. ," 
derreter: " Um toxicodependente nessa fase não tem emprego, já derreteu eventuais economias próprias e alheias, já foi rejeitado pela família e a droga é o seu único modo de vida.," 
desbaratar: " Nós não temos que desbaratar esta herança que recebemos, mas passar para as gerações que virão após nós.," 
desfazer: " Desfazer um patrimônio.," 
desgovernar: "  Desgovernou a herança insensatamente.," 
desperdiçar: " O irmão mais novo, um tolo, foi a seu pai e pediu-lhe a parte dos bens que lhe pertencia, e partiu de casa para desperdiçar sua herança numa vida dissoluta.," 
destroçar: " Destroçar a herança.," 
devorar: " Este teu filho devorou teus bens com prostitutas.," 
dilapidar: " O que teria levado um industrial alemão à opção de salvar a vida de seus operários judeus, dilapidando uma fortuna acumulada pela via da esperteza e do trabalho escravo?," 
dissipar: " O protetor não pode dissipar o patrimônio da protegida.," 
engolir: " O BFC, um banco múltiplo com pouquíssimos correntistas, engoliu US$ 97 milhões do dinheiro público.," 
entornar: " Entornou toda a herança do pai.," 
esbanjar: " Não pense que emergente tem dinheiro para esbanjar.," 
estragar: " Estragou toda a herança no jogo.," 
extinguir: " Extinguiu a herança em poucos meses.," 
extravaganciar: " Extravaganciou a herança paterna.," 
fundir1: " Em pouco tempo fundira tudo quanto herdara.," 
gastar: " O escritor caribenho Derek Walcott já mandou avisar que gastou tudo o que recebeu com o prêmio Nobel em 92.," 
malbaratar: " Não conseguiram malbaratar o dinheiro herdado. ," 
malbaratear: " Requeremos que V.Excia. determine todas as medidas administrativas e judiciais necessárias à punição de todos os responsáveis que contribuíram para malbaratear recursos públicos.," 
malgastar: " Os empregados do meu pai várias vezes malgastavam substanciais quantias de dinheiro.," 
perder: " O segundo marido da avó perdeu fazenda e meia jogando no bicho, baralho e loteria. ," 
prodigalizar: " Prodigalizou a fortuna do pai.," 
queimar: " Não há motivo para você tirar dinheiro da poupança para sair queimando suas economias por aí." 
}
Alinhamento
  ILI: 01159439
  Synset: fritter, frivol_away, dissipate, shoot, fritter_away, fool, fool_away
  Glosa/Exemplo: spend frivolously and unwisely; "Fritter away one´s inheritance" 
  Tipo Semantico: verb.comsumption

