Chave: ROUBAR
Glosa: apoderar-se de algo sem o consentimento do proprietário
Tipo Semantico: verb.possession
{
abafar: " Os gatunos abafaram todas as mercadorias da loja.," 
afanar: " Um deputado, Jonas Pinheiro, nem ao menos se peja de dizer que afanou, como um gatuno qualquer, um documento da Subcomissão de Patrimônio.," 
agadanhar: " Um menino de cerca de 10 anos de idade, foi à Loja da Noiva comprar um par de meias e ao sair agadanhou uma peça de chita e introduziu-a sorrateiramente em uma bolça de palha.," 
arrancar: " Eles tentam arrancar os relógios das vítimas pelas janelas dos carros e depois saem correndo.," 
arrebatar: " rrebataram-lhe todo o dinheiro que trazia consigo.," 
bater: " Não sou o público alvo dos ladrões, quem é que vai querer bater a carteira de um crioulo?," 
bifar: " Bifaram dois talheres de prata.," 
bispar: " Bisfar umas maçãs na feira.," 
comer: " Os mesários comeram tudo o que puderam.," 
despojar: " Os piratas despojaram o navio. ," 
desvalijar: " Essas administrações desbragadas, uma de cujas mãos entra sorrateiramente nas arcas do erário, para as desvalijar do que com a outra metem nas algibeiras à imprensa corrompida. ," 
empalmar: " Vi-o arrebatando-me o chaveiro para surripiar as últimas jóias de sua mãe, vi perfeitamente quando você empalmou o dinheiro.," 
escamotear: " Escamoteou a carteira do banqueiro com um leve toque de mão.," 
escorchar: " Os arrombadores escorcharam o celeiro.," 
esponjar: " Esponjou vultosa quantia dos cofres públicos.," 
furtar: " Alexandre foi acusado de furtar uma bicicleta e preso pelos dois policiais apesar de não ter sido pego em flagrante.," 
gatear: " Ele esperou o momento propício para gatear os doces.," 
gatunar: " Santo Agostinho relata a famosa história pessoal do roubo" 
gatunhar: " O nosso corajoso ato de furtar, roubar, gatunhar a nossa querida placa de pedestres.," 
larapiar: " Os infratores disseram que queriam ser fotografados, enquanto a atendente foi com um dos elementos para o estúdio fotográfico, o outro aproveitou a oportunidade para larapiar a máquina fotográfica.," 
limpar: " A quadrilha limpou os cofres de três agências bancárias.," 
pelar1: " Os assaltantes pelaram a vítima.," 
rapar: " O malandro rapou a carteira do incauto cidadão.," 
rapinar: " Gatunos ficam à espreita da residência, aguardando a saída das pessoas para rapidamente rapinar a moradia.," 
roubar: " Nelsinho fugiu de Santa Cruz, depois de roubar roupas no varal da casa vizinha a que era mantido em cativeiro.," 
safar: " Safaram-lhe a carteira.," 
saltear: " Escravos e libertos reunidos em Palmares por necessidade de sobrevivência  desciam para saltear os engenhos vizinhos.," 
saquear: " A polícia de Vitória salvou do linchamento três homens acusados de saquear lojas após a explosão no mercado da cidade.," 
sonegar: " Sonegaram-lhe o ordenado.," 
subtrair: " O moleque subtraiu uma maçã ao quitandeiro.," 
surripiar: " Dizem mesmo que o delegado-inspetor surripiou objetos para pôr mais à mostra o descaso dos seus subordinados. ," 
surrupiar: " Você age como aqueles dois fedelhos que há alguns anos tentaram surrupiar e danificaram as Graças da Galeria 24 de Março.," 
tirar: " Estes malcriados tiraram dinheiro de uns meninos que vinham com boizinhos.," 
tomar: " Robin Wood só quer saber de tomar a grana de quem tem, para que ele possa socializar esse dinheiro com quem necessita.," 
unhar: " Unhou a carteira do pacóvio." 
}
Alinhamento

