Chave: ENGANAR
Glosa: fazer alguém acreditar em uma inverdade
Tipo Semantico: verb.communication
{
bigodear: " Assim ia ele levando a vida, sempre assentado no balcão, acariciando o bigode e bigodeando os fregueses.," 
burlar: " Fãs burlam a segurança.," 
capear: " Aquela cara de santa capeou-o por muito tempo.," 
codilhar: " Mas tanto Oribe como Rivera nos codilhavam quando podiam, porquanto faziam também suas fosquinhas aos legais. ," 
defraudar: " Um membro da igreja defraudou seu irmão numa transação comercial.," 
despistar: " Kim Clijsters despistou a imprensa e se casou na manhã desta sexta-feira com Brian Lynch.," 
desvairar: " São os psicopatas sociais que mais contribuem para afetar ou prejudicar a vida dos grupos e desorientar ou desvairar as multidões.," 
embromar: " Ele embromou tanto, mandou até o leôncio para embromar os franceses, e perdemos o jogador.," 
embrulhar: " O guarda se postava em seu caminho, ele tranqüilamente metia sua conversa em português, desconversava, driblava, embrulhava.," 
embuçalar: " Apesar de arisca, era foliona e embuçalava um cristão,  só pelo falar, tão cativo.," 
emburricar: " Há pelo menos duas décadas eles têm-se dedicado com afinco ao emprego dos métodos e das práticas gramscianas, emburricando as massas e enganando a maioria.," 
engabelar: " No final, ele a engabelou, pois era o melhor enganador.," 
engambelar: " Stalin engambelou milhares com este discurso.," 
enganar: " O operador do Daiwa, que atuava em Nova Iorque, enganou a fiscalização do Japão, dos Estados Unidos e a empresa de auditoria Ernst & Young.," 
enrascar: " O Lula nos enrascou.," 
enrolar: " O prefeito João Paulo enrolou o arquiteto Oscar Niemeyer.," 
fraudar: " Na última parte do documento, ele assegura que jamais fraudou o Estado nem obteve proveito ilegal no exercício do cargo.," 
iludir: " Iludiram-no sobre as verdadeiras finalidades do filme e por fim manipularam a montagem, alterando o sentido de suas palavras. ," 
intrujar: " Este homem estava a fazer vulgares truques de invocação de espíritos e a intrujar as pessoas, levando-as a pensar que comunicava com os mortos.," 
lograr: " um homem chamado de Jack, conhecido por beberão e baderneiro, logrou o diabo que o perseguia ao subir em uma árvore.," 
ludibriar: " Hermann Goering ludibriou um carrasco com uma cápsula de cianeto, duas horas antes de começar as execuções.," 
mamar: " O gatuno mamou o soldado.," 
mistificar: " Borges mistificou os leitores ao imitar vários idiomas de épocas distintas.," 
tapear1: " A Comroad tapeou os auditores em relação às receitas.," 
tungar: " Estimulou o trabalho informal, tungou os aposentados e foi incapaz de tomar medidas compensatórias para reduzir os efeitos do desemprego.," 
velhaquear: " nicialmente ele vai velhaquear e bastante, e você deve tentar evitar que ele o faça.," 
}
Alinhamento
  ILI: 00826744
  Synset: deceive, betray3, lead_astray
  Glosa/Exemplo: cause someone to believe an untruth; "The insurance company deceived me when they told me they were covering my house" 
  Tipo Semantico: verb.communication

