Chave: DESMERECER
Glosa: falar desfavoravelmente [sobre]
Tipo Semantico: verb.communication
{
caluniar: " Caluniavam o pobre rapaz.," 
demolir: " Estão demolindo os mitos.," 
denegrir: " Não entendo por que as pessoas adoram denegrir a imagem desse rapaz.," 
desacreditar: " Para defendê-lo, seu advogado adotará a estratégia de desacreditar a idoneidade dos denunciantes.," 
desclassificar: " Antônio Carlos Magalhães desclassifica as denúncias do jornalista Luiz Cláudio Cunha.," 
descreditar: " Eles tendem a estigmatizar, e injustamente descreditar as pessoas.," 
desdoirar: " Opiniões pessoais não desdoiram o Espiritismo.," 
desdourar: " Desde há algum tempo deixei de ver graça em atitudes que, além de não nos promover como Pátria e Cidadãos, apenas nos desdouram, nos desqualificam.," 
deslustrar: " João de Barros omite tudo quanto possa deslustrar os reis e os grandes personagens, assim como o decoro da nação portuguesa.," 
desmerecer: " Algumas vezes ele e seus seguidores desmereceram a pesquisa empírica na psicolingüística, objetando que suas teorias têm a ver com a competência idealizada e não com os fatos do desempenho individual.," 
desmoralizar: " Então o prefeito está tentando desmoralizar a segurança do estado?," 
desonestar: " Negar um provimento jurisdicional desta grandeza seria desonestar o próprio remédio constitucional que tutela o magnífico bem da liberdade contra arbitrariedades providas do Poder Publico.," 
desonrar: " Desonrava o sacerdócio, ultrajando o Cristo com exemplos de desmoralização e de ganância pervertedores do rebanho católico.," 
detrair: " Prossegue em detrair-me, em praguejar-me.," 
detratar: " Comprometera-se a não detratar os matadores de César em público.," 
difamar: " Ele acrescenta que Romano não tinha a intenção de injuriar ou difamar Cardoso Alves.," 
enegrecer: " Se difundam notícias dirigidas a enegrecer cada vez mais a imagem da Justiça, em geral e dos Juízes, em especial, perante a opinião pública.," 
enxovalhar: " Enquanto o objetivo é o de enxovalhar a imagem dos profissionais servidores públicos, vamos continuar a amargar as filas do INSS, da Polícia Federal, etc.," 
ignominiar: " Abominável pecado ignominiara-o.," 
infamar: " Afastem-se do exemplo de infamar sem prova.," 
injuriar: " Ele acrescenta que Romano não tinha a intenção de injuriar ou difamar Cardoso Alves.," 
manchar: " Ou ele liberava o patrocínio ou ela entregava as fitas à imprensa, manchando a imagem da empresa.," 
mazelar: " O escândalo mazelou-a.," 
obscurecer: " Os craques sempre conseguem driblar os infortúnios e uma hora fazem o sol de sua arte iluminar o que as mentes daninhas tentam obscurece.," 
rebaixar: " Convertê-la em um meio de alcançar outros objetivos que lhe são estranhos, equivale a rebaixar o mérito da obra.," 
vituperar: " Não se trata, pois, de elogiar ou vituperar a linguagem de Portugal ou a do Brasil." 
}
Alinhamento
  ILI: 00820582
  Synset: badmouth, malign, traduce, drag_through_the_mud
  Glosa/Exemplo: speak unfavorably about; "She badmouthes her husband everywhere" 
  Tipo Semantico: verb.communication

