Chave: DENEGRIR
Glosa: acusar falsamente ou com intenção maliciosa, atacar o nome ou reputação de alguém
Tipo Semantico: verb.communication
{
caluniar: " Nunca caluniou ninguém, tendo concentrado o discurso nas propostas para um Portugal de futuro.," 
demolir: " A revista demoliu o filme antes dele entrar em cartaz.," 
denegrir: " O carnaval só serve para denegrir a imagem do Falabella.," 
desacreditar: " Rompeu com o amigo e tentou desacreditá-lo. ," 
desclassificar: " A argumentação nunca deve deser ao insulto, ou ao ataque pessoal, que só desclassifica e nunca clarifica.," 
descreditar: " Nós encontramos Gish tentando descreditar Davidson Black.," 
desdourar: " Contudo, desde há algum tempo deixei de ver graça em atitudes que além de não nos promover como Pátria e Cidadãos; apenas nos desdouram, nos desqualificam.," 
deslustrar: " Eles próprios deslustram o caráter.," 
desmerecer: " Isto não desmerece nem a ele nem a outros.," 
desmoralizar: " “Não conseguiram me subornar nem me intimidar, então tentam me desmoralizar”.," 
desonrar: " São atos que o desonram.," 
detrair: " Vivia detraindo o governo.," 
detratar: " Fiquei impressionado com a falta de educação da pessoa que detratou o nosso estado e a nossa Veneza brasileira.," 
difamar: " Breno disse que o pai o difamava.," 
enegrecer: " Criminalizar o comunismo é enegrecer o passado comunista para melhor excluir as perspectivas do futuro da humanidade ao destruir a perspectiva revolucionária. ," 
infamar: " Vossa Senhoria infamou a função de presidente da Câmara e maculou sua história política ao trazer a policia militar para coibir as legítimas provas.," 
injuriar: " A aluna injuriou o professor.," 
macular: " Pupetta dizia que o filme maculava sua honra .," 
marear: " As adições marearam o texto original.," 
rebaixar: " Peço que pense em quantas vezes seu chefe te rebaixou, quantas humilhações já sofreu.," 
vituperar: " Vituperava os fracos e desleais.," 
}
Alinhamento
  ILI: 00818976
  Synset: defame, slander, smirch, asperse, denigrate1, calumniate, smear, sully, besmirch
  Glosa/Exemplo: charge falsely or with malicious intent; attack the good name and reputation of someone; "The journalists have defamed me!" "The article in the paper sullied my reputation" 
  Tipo Semantico: verb.communication

