Chave: TEIMAR
Glosa: ser insistente e se recusar-se a mudar
Tipo Semantico: verb.communication
{
aferrar-se: " "Seu" Faustino aferrou-se à luta pela sobrevivência e ao zelo familiar, com tanto afinco, que não teve oportunidade ou tempo para alfabetizar-se.," 
afincar-se: " Ela, porém, longe de se curvar diante da majestade de Deus, afincou-se no seu orgulho.," 
amarrar-se: " Amarrava-se intransigentemente àquele parecer.," 
amuar: " muou em partir no dia seguinte.," 
caturrar: " Os graves doutores, na terra clássica das sangrias, caturravam negando a circulação do sangue, mais de um século depois de Harvey.," 
empeiticar: " Por qualquer tolice pôs-se a empeiticar com a mulher.," 
emperrar: " O pessoal do Banco do Brasil emperrou com algumas cláusulas econômicas do acordo feito com a Fenaban.," 
encafifar: " O mais radical dos petistas encafifou uma idéia, não se deixa pressionar por ninguém.," 
encasquetar-se: " Encasquetou-se-lhe na cabeça que há de ser por força ministro.," 
entesar: " Entesava em ficar. Enquanto pôde alimentar as criações, ia vivendo de vender um porquinho, comer ovo, galinha, resto de macaxeira do roçado.," 
fincar-se: " Milton Friedman fincou-se nos princípios da teoria monetária da renda nominal, consequência da coerência dos consumidores, trabalhadores, poupadores e empresas no mercado.," 
insistir: " A produtora Kátia Lund insistiu em retirar os mesmos jornalistas do morro e bastou que citassem o nome de Marcinho VP para que os seguranças desistissem de cumprir a ordem. ," 
marralhar: " arralhar com alguém.," 
martelar: " Na minha cabeça uma pergunta martelava incessante" 
obstinar-se: " A China obstinava-se na arrogância de ser a potência mundial hegemônica, postura estimulada pela desconfiança da classe dominante imperial mandchú.," 
porfiar: " Porfiava em ensandecer os ousados ouvidores que não acreditavam ser ele capaz.," 
recalcitrar: " D. Benedita recalcitrou um pouco, mas aceitou o prazo, dando desde logo todas as ordens necessárias à construção do túmulo.," 
renitir: " Saiu a campo na defesa dos perseguidos e renitiu no seu apostolado de paladino da proteção dos direitos dos cidadãos.," 
teimar: " Quis falar de outras cousas; ela, porém, teimava no assunto da viagem, para familiarizarmos com a idéia, e moralmente constranger-me a realizá-la. ," 
tungar: " Tungar sobre alguma coisa.," 
turrar: " Mas Fadim turrava de continuar de coturno, nem quis olhar os sapatos de salto que a menina trouxera roubados da mãe.," 
}
Alinhamento
  ILI: 00792187
  Synset: insist, take_a_firm_stand
  Glosa/Exemplo: be insistent and refuse to budge; "I must insist!" 
  Tipo Semantico: verb.communication

