Chave: ZOMBAR
Glosa: ridicularizar com desprezo e escárnio
Tipo Semantico: verb.communication
{
apodar: " E pra cúmulo de tudo apodam a população de ignorante.," 
bigodear: " Sempre que pode, bigodeia a pobre beata.," 
brincar: " Dona Maricota ainda quis brincar, troçar a filha, porém, voltou-se para o outro lado, pôs-se a dormir, com um leve respirar espaçado. " " A propaganda é apenas uma brincadeira, sem intenção de ofender ou brincar com qualquer religião.," 
cachetar: " Está sempre a cachetar dos outros.," 
caçoar: " Quando voltei para o Rio, com 11 anos, fiquei um ano muda" 
chacotear: " Uma tarde, de volta a casa, um grupinho de estudantes vadios pôs-se a chacotear-me.," 
chalaçar: " Pelo meio da festa, o Quinquim, gigantesco de gordura, queimando a quadrilha pra variar, como chalaçava o sobrinho, que era um marcante espalhafatoso de bons dizeres e muita chufa.," 
chalacear: " Podia-se chalacear e troçar os amigos, mas como cavalheiros!," 
chasquear: " Formavam dizia este último, chasqueando, sem tirar o charuto da boca uma respeitável trindade filosófica.," 
chocarrear: " Croce nos adverte contra os "jeunes" das cervejarias que vivem a chocarrear nos velhos e nos mestres.," 
debicar: " Quem disse a V.S.ª que isto aqui é uma tenra de beócios, onde os pedantes arranjam bons casamentos, debicou-o, respeitável senhor, debicou-o redondamente.," 
debochar: " Deixaram de debochar de sua paixão pelo ciclismo, de suas gordas bochechas, da sua feiura, das suas roupas deselegantes, até do seu sotaque, típico dos italianos nascidos na região da Emilia Romagna.," 
derriçar: " Ele estava sempre derriçando com o irmão.," 
desfrutar: " Gostava de desfrutar os tolos e os vaidosos.," 
escarnecer: " O aventureiro ficou espavorido; decididamente esse homem era um espírito infernal que planava sobre o abismo, e escarnecia do perigo; um ente superior a quem a morte não podia tocar.," 
galhofar: " Podemos enfim gozar da liberdade de expressão, liberdade esta, que me permite escrever em entrelinhas simplesmente para galhofar da inoperância destes que ainda procedem arcaicamente.," 
gozar: " Porque os mesmos homens que são bons amigos e companheiros carinhosos pertencem simultaneamente a uma natureza selvagem que goza da morte e do sofrimento alheio e que parece gozar, obscuramente, até do próprio sofrimento e da própria morte dolorosa?," 
gracejar: " Foi preciso um esforço sobre-humano para esconder de minha mãe a certeza que eu tinha sobre o meu estado e para gracejar dos seus temores, que eu chamava imaginários.," 
ironizar: " Mas a minha idéia era chegar aos 100 gols contra o Flamengo, para ironizar o centenário.," 
malhar: " Também foi assim no início dos anos 30, quando os adeptos do jazz tradicional de Nova Orleans e Chicago começaram a malhar o nascente swing.," 
mangar: " Logo começaram a mangar dela.," 
mexer: " Qual foi a primeira marcha carnavalesca a mexer com o regime militar?," 
mofar1: " Tinha até umas sombras de riso cáustico, um riso de seu uso, quando mofava de alguém, parecia ter dito um epigrama.," 
motejar: " Havia aí grande agitação; uns falavam em tom de queixa, outros murmuravam apenas palavras entrecortadas; e alguns finalmente riam e motejavam do descontentamento de seus companheiros.," 
pagodear: " Como pagodearam do rapaz! " " Não leva ninguém a sério" 
palhetar: " Palhetar de alguém.," 
pilheriar: " Eu vi os padres zombar e pilheriar dos romeiros.," 
ridicularizar: " Decidir ridicularizar uma pessoa é quase como assassiná-la.," 
ridiculizar: " Olhei... fixei com a minha luneta mágica o demônio que assim tão barbaramente me ridiculizava... encarei o... observei o com ódio.," 
rir: " A vizinhança veio para a rua assistir ao trabalho e parecia rir de mim.," 
satirizar: " Novela da Globo irá satirizar o ex-presidente Fernando Collor.," 
sorrir: " Pouco depois, saindo à rua, Falcão sorria da resistência de D. Fernanda em aceitar a sua hipótese.," 
sotaquear: "  Sotaquear o colega apaixonado.," 
troçar: " Ben Gurion, um dos heróis de Israel, costumava troçar dos americanos quando eles se gabavam pelos antepassados que chegaram no Mayflower, há cerca de 300 anos.," 
trotar: " Poxa, se é para zoar, frescar, trotar da cara da gente, então por que inventou a droga desse projeto?," 
zingrar: " Zingrou-o na presença de todos.," 
zombar: " Todos zombam dele, e devem zombar; porque o néscio esbanjou em menos de dois meses a terça parte pelo menos da fortuna que possuía!," 
zombetear: " Hagen e Volker zombetearam, olharam com desprezo e se acovardaram." 
}
Alinhamento
  ILI: 00822606
  Synset: jeer, scoff, flout, barrack, gibe
  Glosa/Exemplo: laugh at with contempt and derision; "The crowd jeered at the speaker" 
  Tipo Semantico: verb.communication

