Chave: VANGLORIAR-SE
Glosa: exibir-se
Tipo Semantico: verb.communication
{
alardear-se: " O usurário alardeava-se de ser generoso.," 
arrear-se: " Arreava-se de seu título.," 
avantajar: " Vive a avantajar entediando os presentes.," 
bazofiar: " Não custava nada bazofiar numa roda de esquina que se pretendia isto ou aquilo.," 
blasonar: " Está sempre a blazonar, mas nunca prova o que diz.," 
bravatear: " Enquanto o presidente Lula bravateia com a estória do Primeiro Emprego, muitos brasileiros ainda correm atrás do último.," 
campar: " Campava de ter bom tino.," 
desvanecer-se: " Orgulho-me e me desvaneço de nossa amizade de perto de meio século.," 
exaltar-se: " Não se exaltava com facilidade, mesmo sabendo de suas qualidades.," 
fumacear: " Fumaceava de valente.," 
gabar-se: " Cláudio Assis se gabava da qualidade do seu filme.," 
gargantear: " Garganteava sobre sua suposta vitória.," 
gloriar-se: " O homem, que se gloria de ser o único animal racional, deve usar sua inteligência, e não só seus sentidos, para atingir conhecimentos científicos e agir.," 
glorificar-se: " Tudo o que a mulher lutou e se glorifica de ter conseguido nada mais representa do que a falência de nossa sociedade.," 
honrar-se: " A Obra Salesiana se honra de ter Dom Bosco, Pai e Mestre da juventude, como seu fundador.," 
jactar-se: " Muita gente se jacta de ter acabado com o crime organizado no Estado, mas nunca tomou a linha de frente para combatê-lo.," 
lisonjear-se: " A atriz lisonjeou-se com as críticas à sua atuação.," 
louvar-se: " É surpreendente que um país que se louva por contar com um povo criativo, tenha um nível tão baixo de inovação tecnológica e de registros de patentes.," 
pespontar: " Muitos ignorantes pespontam de sábios.," 
presumir: " Todo e qualquer escritor se presumia de estilista, e isso, na época, significava riqueza vocabular .," 
prezar-se: " Prezar-se de ser educado é prova de não o ser.," 
prosear: " Proseia muito e nada realiza.," 
roncar: " Roncava de intelectual, mas não tinha nada daquela imagem.," 
timbrar: " O Governo brasileiro timbrou sempre em manter a mais estrita neutralidade e seguir política de escrupuloso respeito às soberanias alheias.," 
ufanar-se: " O nosso povo passou a ter apenas identidade, mas não mais se ufanava de sua cidadania.," 
vangloriar-se: " Ele se vangloriava de ter planejado uma cilada para matar o agente da polícia secreta israelense.," 
}
Alinhamento
  ILI: 00853748
  Synset: 
  Glosa/Exemplo: show off 
  Tipo Semantico: verb.communication

