Chave: PREVER
Glosa: fazer uma previsão [sobre]; dizer de antemão
Tipo Semantico: verb.communication
{
adivinhar: " D. Henrique adivinhou as aspirações de seu sobrinho acerca da sucessão do trono.," 
agoirar: " Foi Sapas quem Iagoirou a derrota de Much perante Aleyin.," 
agourar: " Marx, em raciocínio simétrico, agourou que no estágio final do comunismo aconteceria a inutilidade do Estado e, portanto, da Política..," 
ante-sentir: " Mas poucos foram os governantes que, ante-sentindo o fenômeno, se anteciparam às reivindicações que então apenas sussurravam na consciência adormecida.," 
antecipar: " Com esta atitude, ele estava refletindo, senão antecipando, mudanças semelhantes que ocorriam na psicologia e na inteligência artificial.," 
antedizer: " Mas Ele, antevendo e antedizendo, começa alertando para que tomemos cuidado com os "falsos profetas" e "falsos doutores", "hereges" e "falsos pastores".," 
anunciar: " O próprio Einstein, que, contudo, anunciava o caráter cada vez mais abstrato das teorias futuras, vacilava em abandonar a «idéia de uma representação direta da realidade no espaço e no tempo. ," 
augurar: " O Conselho de Assessores Econômicos do presidente augurou a criação de 2,6 milhões de trabalho este ano em um relatório apresentado ao Congresso.," 
auspiciar: " Na mensagem enviada ao congresso, o papa João Paulo  auspiciou o incremento da compreensão e da solidariedade para a população cigana.," 
fadar: "  cartomante fadou-lhe vida longa.," 
farejar: " Paulo Freire farejou o caminho hoje trilhado por muitas empresas que tomaram os próprios problemas onde seus funcionários estavam fracassando e fizeram deles o foco e a cartilha do aprendizado.," 
preanunciar: " Ora, tendo a Escritura previsto que Deus justificaria pela fé os gentios, preanunciou o evangelho a Abraão" 
predizer: " A teoria de Einstein predizia um efeito, que só devia ser verificado dez anos mais tarde por Robert Millikan86, relativo ao potencial de parada dos elétrons emitidos pela radiação luminosa .," 
prenunciar: " O escritor e filósofo francês prenunciou os horrores da guerra civil na Iugoslávia de forma espetacular.," 
pressagiar: " Pois em lugar de prenunciar um período de crescimento sereno e seguro, pressagia uma geração plena de turbulências e convulsões em toda a região do Pacífico Asiático .," 
pressentir: " Tinha este deposto o copo sobre o imundo balcão quando pressentiu a arremetida; pode por isso fugir em tempo com o corpo à violenta pancada .," 
prever: " Pessimista, Bacha previu que a dívida interna vai crescer ainda mais .," 
profetizar: " Segundo o rabino Isaac Michaan, Schneerson profetizou mudanças recentes e positivas no cenário político mundial .," 
prognosticar: " A revista «Premiere» prognosticou que o filme seria o nº 1 do verão americano de 1994 .," 
saber: " Aqui, empresários argentinos e os pesos pesados que formam o World Economic Forum (WEF) , a organização não governamental que reúne as 1.000 companhias mais poderosas do mundo, querem saber o futuro do Plano Real e se Fernando Henrique será reeleito.," 
vaticinar: " Como essa coluna vaticinou há cerca de um ano, a tendência será desaparecer como empreiteira .," 
}
Alinhamento
  ILI: 00887706
  Synset: predict, foretell, prognosticate, calla, forebode, anticipate, promise2
  Glosa/Exemplo: make a prediction about; tell in advance; "Call the outcome of an election" 
  Tipo Semantico: verb.communication

