ANÁLISE DA GLOSA4009

DADO O SYNSET:

S='Glosa4009'
{acrisolar: Desde a mais remota antiguidade, porém discutem as escolas filosóficas sobre o que mais convém ao homem como criatura de Deus: se viver vida longa, I]acrisolando o espírito entre os mortais.,
acurar: H]Acuramos nossa técnica graças à prática.,
afiar: Na verdade, o menino Autran ainda não concatenava letras: [afiou a imaginação e criou uma história complicadíssima .,
afinar: As cúpulas do PSDB e do PFL reúnem-se hoje, no Palácio Jaburu, com o objetivo de [afinar a linguagem e agilizar o processo de reformas .,
alambicar: A velha senhora respondia-lhe no mesmo tom, I]alambicando a frase, dando-lhe uns jeitos de quem tem trato de salão.,
amadurecer: Eu venho [amadurecendo a idéia há muito tempo .,
aparar2: Fazia questão de H]aparar o modo de vestir.,
aperfeiçoar: introdução das raízes de inverno nabo e beterraba e de culturas verdes alfafa, trevo não só permitiu o uso contínuo da terra e melhoria na alimentação dos animais, mas também [aperfeiçoou a qualidade dos rebanhos .,
aprimorar: O cientista Robert Hooke, na Inglaterra, [aprimorou um microscópio e resolveu examinar um pedaço de cortiça .,
apurar: Com a experiência,  seu estilo H]apurou.,
bolear: M]Boleava definições do dicionário.,
burilar: Nesse campo, para [burilar sua imagem, ele hoje - embora permaneça como técnico e estrategista do time de investidores do Quantum - gasta uma substancial parte do seu tempo envolvido em trabalho filantrópico no Leste da Europa .,
cinzelar: O orador M]cinzelava as frases.,
cizelar: x,
consumar: Os assaltantes A]consumaram sua crueza seviciando as vítimas.,
crisolar: x,
desbastar: Lula vestiu o figurino de centro ainda como candidato e I]desbastou o discurso ideológico.,
desbastecer: H]Desbastava os modos de uma criança selvagem.,
desenvolver: Ele precisa H]desenvolver bastante sua mediunidade.,
esmerar: Precisava H]esmerar sua técnica de pintar.,
esmerilar: x,
esmerilhar: Reinaldo I]esmerilhou ao lado de Luís Fabiano.,
estilizar: O problema dos «erros» gramaticais nas falas levou Gladstone a afirmar, generalizando, que «em diálogos, embora [estilizando a linguagem, os bons escritores procuram reproduzir a maneira de falar dos interlocutores".,
facetar: Tentava H]facetar o sentido das palavras.,
facetear1: x,
limar: M]Limava versos, discursos, poesias.,
madurar: x,
madurecer: x,
melhorar: Depois do recorde de ontem, ele disse que aprendeu com os erros e [melhorou sua técnica nos últimos tempos .,
perfeiçoar: x,
polir: Era um escritor que tinha prazer em H]polir o estilo.,
primorar: x,
refinar: O professor Selten expandiu e [refinou a teoria de equilíbrio de Nash, para incluir conceitos de como se formam estratégias ao longo do tempo .,
reformar: Com o Folhão, o jornal criou um roteiro gratuito de vagas de emprego e [reformou sua edição acrescentando a ela mais serviços (em cadernos como Imóveis, Tudo, Veículos e Empregos; Finanças veio em seguida) , mais reportagens especiais, mais atrações (na Revista da Folha e no TV Folha) .,
requintar: Em alguns países, o comunismo [requintou a perversidade.,
subtilizar: Nesta etapa aprendemos a I]subtilizar nossas percepções ea capacitar nossos sentidos para perceberem o fluxo desta energia circulando pelo corpo.,
sutilizar: Quem visa I]sutilizar o corpo físico contribui para I]sutilizar também a contra-parte estética.,
tornear: Fazia tudo: H]torneava um verso, uma frase, o estilo.,}
	  
A='Glosa604'
{piorar: A idéia do manifesto saiu da cabeça de Cristóvam, que, para [piorar o humor dos petistas, voltará a Brasília a bordo do Boeing presidencial ao lado de FH. ,}
  
A ANÁLISE RESULTA EM:

S='Glosa4009B' = “tornar afiado ou aguçar”
{afiar: Na verdade, o menino Autran ainda não concatenava letras: [afiou a imaginação e criou uma história complicadíssima ., }
Chave: AFIAR <verb.change>
ILI: 00380508

Sense 2
{00380508} <verb.change> sharpen1 -- (make sharp or sharper; "We had to sharpen our arguments")
       => {00219593} <verb.change> intensify1, compound1, heighten4, deepen1 -- (make more intense, stronger, or more marked; "The efforts were intensified", "Her rudeness intensified his dislike for her"; "Potsmokers claim it heightens their awareness"; "This event only deepened my convictions")
           => {00150804} <verb.change> increase -- (become bigger or greater in amount; "The amount of work increased")
               => {00163165} <verb.change> change magnitude -- (change in size or magnitude)
                   => {00106479} <verb.change> change -- (undergo a change; become different in essence; losing one's or its original nature; "She changed completely as she grew older"; "The weather changed last night")