Chave: BASEAR-SE
Glosa: usar como base, fundar-se em
Tipo Semantico: verb.cognition
{
alicerçar-se: " O sentimento evocado pelo percurso da memória do poeta alicerça-se sobremaneira na nostalgia, aprofundada nas imagens que evocam a tranqüilidade perdida.," 
apoiar-se: " O humanismo integral de Vergílio Ferreira, portanto, apóia-se no princípio de que o ser deve encontrar seu próprio espaço no Universo definitivamente abandonado pelos deuses. ," 
arrimar-se: " O autor arrima-se na doutrina, apresentando conceitos, princípios, classificações e exemplos práticos que atribuem à obra grande valor prático. ," 
assegurar-se: " A importância da viabilidade econômica do quarto tratamento assegura-se no fato deste utilizar exclusivamente adubos orgânicos.," 
assentar-se: " Essa concepção assenta-se numa acepção específica do vetor de estado de um sistema, considerado como representando não o sistema em si mesmo, mas apenas o conhecimento que dele temos.," 
basear-se: " O estudo do professor Knut Aagaard, da Universidade de Washington em Seattle, nos EUA, baseia-se nos dados coletados em um mês numa viagem através do Oceano Glacial Ártico, do Alasca à Islândia.," 
cimentar-se: " Aprendendo as culturas do seu meio de criação, foram depois cimentar-se nas comparações, e sempre dispostos a abrir a mente para novos conhecimentos.," 
consistir: " A principal importância comercial do pau-brasil para a metrópole portuguesa consistia na sua utilização na indústria de móveis coloniais. ," 
consolidar-se: " mpunemente, a indústria do crime consolida-se em audácia e atrevimento dentro de uma sociedade em decomposição.," 
embasar-se: " A filosofia do RU embasa-se na trajetória da prestação de serviços que vem se desenvolvendo no decorrer de seus 28 anos à comunidade universitária.," 
encastelar-se: " Aqui, a direita encastelou-se na academia, com prerrogativas de chamar de filósofo a todo e qualquer professor que tenha se banhado no rio de Heráclito.," 
escudar-se: " A certeza da salvação que defendemos, escuda-se na convicção da verdade da Palavra de Deus sobre nossa consciência.," 
estear-se: " O sistema sindical no Brasil esteia-se em divisão por categorias profissionais e econômicas. ," 
estribar-se: " A teoria da responsabilidade civil objetiva do Estado estriba-se na tese de que, como os cidadãos compartilham das benesses oferecidas pelo Estado, devem, também, dividir os prejuízos sofridos por algum ou alguns de seus membros. ," 
firmar-se: " E toda a sua resenha firma-se nessa inverdade.," 
fundamentar-se: " O questionário fundamenta-se nas teses apresentadas pela defesa e pela acusação.," 
fundar-se: " Isso significa que Marx funda-se em uma interpretação bem determinada do mundo para exigir sua transformação.," 
jogar: " Defendeu bem a tese, jogando com excelentes autores," 
librar-se: " Libram-se em frágeis razões.," 
louvar-se: " O pedido louva-se na proteção assegurada pela Constituição Federal de 88, art. 5º, XXX e pelo Código de Propriedade ndustrial.," 
repousar: " O sucesso do alberguismo repousa na Missão e na filosofia que estão enraizadas no movimento. ," 
}
Alinhamento
  ILI: 00616670
  Synset: establish3, base, ground, found
  Glosa/Exemplo: use as a basis for; found on; "base a claim on some observation" 
  Tipo Semantico: verb.cognition

