Chave: MENOSPREZAR
Glosa: julgar muito inferior uma estimativa
Tipo Semantico: verb.cognition
{
amesquinhar: " O enfraquecimento do oponente amesquinhou os vencedores. ," 
arrenegar: " O padre arrenegou são José Maria.," 
conculcar: " ...]conculcar direitos trabalhistas/É um crime ]conculcar a beleza da Matemática," 
depreciar: " O sambista Martinho da Vila depreciou as feministas da década de 70 com "Você não passa de uma mulher"," 
deprimir: " Pelo contrário, ele deprimiu o homem com suas superstições, ao ir contra a natureza, ao tomar como pecado o seu nascimento, a sua origem, o sexo," 
derrear: " Ele derreou o estranho," 
desacreditar: " Além disto, tal sistema desacreditava o país como um parceiro comercial confiável e. transparente, gerando imprevisibilidades e inibindo os investimentos," 
desapreciar: " O santo não desapreciava a ciência, mas não a desejava para seus discípulos/Os naturistas não desapreciam a comodidade e o bem estar material," 
desatender: " Sua Excelência não o desatenderá," 
desconsiderar: " PT desconsiderou militância do partido na campanha de Benedita à reeleição," 
descreditar: " Economista descredita ranking mundial de PBs," 
desestimar: " Ricardo Alarcón desestimou a capacidade que atualmente tem Estados Unidos para tentar algo contra a soberania de Cuba," 
desfavorecer: " O rei os desfavoreceu e lançou de seus paços," 
desluzir: " Desluzir uma obra literária," 
desmerecer: " O treinador da Alemanha Ocidental desmereceu os argelinos ao falar publicamente que os africanos seriam facilmente batidos," 
desprezar: " O ensino exaltava ou valorizava a cultura européia e [desprezava a cultura do colonizado/Desprezava a plebe," 
empalidecer: " ... mesmo que persistam mazelas na saúde pública, não são suficientes para ]empalidecer o triunfo da redução da mortalidade infantil," 
espezinhar: " Morrissey espezinhava Robert Smith e sua banda sempre que tinha oportunidade, assim como provavelmente desprezava U2 e The Police," 
menoscabar: " Na sua modesta lição, menoscabava ele o mérito sublime que é morrer lutando," 
menosprezar: " O Estado brasileiro menosprezou a função dos policiais e muitos deles mudaram de lado.," 
mutilar: " A educação é mutilada.," 
rebaixar: " Gates rebaixou seu papel como o grande inovador da companhia e disse que a Microsoft vai continuar a mostrar liderança para desenvolver os softwares," 
relegar: " Entretanto, ao "sair de casa", a mulher relegou suas atribuições de mãe e esposa," 
renegar: " srael renega os princípios de Oslo," 
}
Alinhamento
  ILI: 00648935
  Synset: underestimate1, underrate
  Glosa/Exemplo: make too low an estimate of; "he underestimated the work that went into the renovation"; "Don´t underestimate the danger of such a raft trip on this river" 
  Tipo Semantico: verb.cognition

