Chave: PENSAR
Glosa: usar ou exercitar a mente ou o próprio poder de raciocínio a fim de fazer deduções, decisões ou chegar a uma solução ou a um julgamento
Tipo Semantico: verb.cognition
{
arrazoar: " E é com uma ponta, talvez, de tristeza, que Denton arrazoa sobre a ironia de se pensar que o que Darwin colocou como sendo um dos seus maiores aliados.," 
atentar1: " Se o inferno que consumiu toda Madri na quinta-feira for resultado do fanatismo islâmico, precisamos atentar para o papel da Espanha na guerra do raque.," 
cogitar: " E entrou a cogitar donde é que o conhecia, porque, em verdade a cara não lhe era estranha, nem as maneiras, nem os olhos plácidos e grandes.," 
conceber: " Nestas ocasiões, conceber que o mundo fosse regido por um deus onipotente, onisciente e bondoso lhe soava como piada.," 
considerar: " Em primeiro lugar, é preciso considerar que, não sendo a fome no Brasil um problema epidêmico, sua natureza é política.," 
contemplar: " Resiste a contemplar nos próprios erros.," 
cuidar: " Deve cuidar muito em aceitar aquela proposta até se decidir.," 
devanear: " É não devanear sobre o passado, mas trabalhar em cima dele para o futuro.," 
discorrer: " Absorto, ele discorria em fatos do passado.," 
discursar: " Sozinho à noite, discursava sobre sua vida.," 
especular: " Descartes a postulou para controlar o risco de ser queimado nas fogueiras da nquisição, enquanto especulava sobre as certezas do pensamento humano.," 
excogitar: " Por isso dirigia Davi suas vistas a este sacrifício, quando excogitava um meio de agradecer a Nosso Senhor pelas graças recebidas.," 
imaginar: " Não imaginava, por exemplo, que o detalhista das melodias fosse capaz de mudar uma notinha sequer de suas composições, por mais que a letra pedisse.," 
mastigar: " Tanto mastigou o negócio que acabou por perdê-lo.," 
matutar: " No fim da adolescência, de tanto matutar entre ser geóloga, astrônoma ou cientista social, acabou pregando estrelinhas em camisetas numa fábrica de Nova York.," 
meditar: " Mas um estudante de ginásio que medita sobre sua solidão em uma praça de Buenos Aires é uma anêmica enteléquia.," 
pensar: " São tão fabricados quanto as reportagens nos tablóides de supermercados, e contrariam tudo o  que uma pessoa medianamente inteligente pensa sobre como as pessoas se comportam na vida real.," 
ponderar: " Ele pondera sobre o Direito-ficção, uma vez que as leis escritas refletem uma determinada época e acabam estancadas no tempo.," 
raciocinar: " Existem, portanto, diferenças consideráveis em como uma dada pessoa pode raciocinar sobre diferentes tópicos, que, de um ponto de vista formal, exigem o mesmo grau (e até os mesmos princípios) de expertise lógica.," 
razoar: " O texto é um de um esplendor poético quase perfeito, é preciso senti-lo antes de razoar sobre ele.," 
refletir: " Queremos discutir um assunto amplo, refletir sobre a situação miserável do sistema penal e carcerário brasileiro.," 
reflexionar: " Compreendia agora; era tudo engano, confusão, o que parecia ser com uma pessoa era com outra, e aí está como a gente pode chegar à calúnia e ao crime, assim reflexionava Rubião.," 
trabalhar: " O espírito trabalha sempre." 
}
Alinhamento
  ILI: 00608615
  Synset: think, cogitate, cerebrate
  Glosa/Exemplo: use or exercise the mind or one´s power of reason in order to make inferences, decisions, or arrive at a solution or judgments; "I´ve been thinking all day and getting nowhere" 
  Tipo Semantico: verb.cognition

