Chave: COMPREENDER
Glosa: apreender (uma idéia ou situação) mentalmente
Tipo Semantico: verb.cognition
{
abarcar: " Aproximamo-nos mais do objetivo científico por execlência, que é abarcar por dedução lógica, mediante um mínimo de hipóteses ou axiomas, um máximo de experiências.," 
abranger: " Com sua pouca percepção, não abrange todos os ângulos do problema.," 
alcançar: " O pensamento racional pode alcançar o conhecimento do real, por intermédio de símbolos, conceitos e princípios que são construções do pensamento.," 
apanhar: " Com o pouco que sabia do francês, tentou apanhar o sentido do que vinha escrito sobre os vários fenômenos da gestação e do parto.," 
apreender: " Para tentar apreender o sentido do relativismo protagórico, é preciso recorrer a dois livros.," 
assimilar: " Ele já tinha elaborado seu método de comunicação com um ser humano que se revelara especialmente apto a assimilar seus ensinamentos.," 
atinar: " A idéia do Ser tem um valor  por detrás, que se esconde em virtude de um jogo curioso, cujas regras é difícil de atinar.," 
atingir: " Os cristãos têm o privilégio de celebrar o Natal em profundidade, atingir o sentido autêntico da festa e, por conseguinte, experimentar a alegria profunda pelo nascimento de Jesus Cristo.," 
captar: " A psicanalista Suzana Katz, mediadora da mesa, foi a primeira a captar o bom humor do público.," 
compreender: " Nós nunca conseguiremos compreender um determinado fenômeno se não o observarmos, o maior número de vezes possível, extraindo das observações o maior número possível de informações (dados).," 
depreender: " Os empresários se entreolhavam, tentando depreender alguma coisa daqueles suspiros.," 
digerir: " O escritor não conseguiu digerir as informações sobre o país contidas em livros de Euclides da Cunha e Gilberto Freyre usados como material de pesquisa.," 
entender: " Para entender esse fenômeno, basta estudar o processo de transformação de ondas sonoras em ondas eletromagnéticas.," 
entoar: " Não entôo com as sutilezas da Teologia.," 
fisgar: " O Aureliano, com aquele seu ar sutil de quem sabe fisgar o humor do instante que passa, exclama" 
interpretar: " A visão, a audição, o tato, o paladar e o olfato constituem os cinco sentidos fundamentais que nos permitem interpretar todos os fenômenos que se passam ao nosso redor, no mundo que nos cerca.," 
pegar: " Pega facilmente tudo quanto lhe ensinam.," 
penetrar: " Penetrar o sentido de um provérbio.," 
perceber: " Querer eliminar as luzes que embelezam a cidade é não perceber a relação de amor entre o carioca e o Rio.," 
pescar: " Foi assim que eu virei publicitário, só por isso, porque eu era bom em pescar idéias. " 
}
Alinhamento
  ILI: 00572258
  Synset: understand1, realize, realise, see1
  Glosa/Exemplo: perceive (an idea or situation) mentally; "Now I see!"; "I just can´t see your point"; "Does she realize how important this decision is?"; "I don´t understand the idea" 
  Tipo Semantico: verb.cognition

