Chave: ENFEITAR
Glosa: fazer mais atraente adicionando ornamento, cor, etc
Tipo Semantico: verb.creation
{
adereçar1: " Assim reflexionava Rubião, saindo para a sala de jantar, onde os copeiros adereçavam a mesa da ceia," 
adornar: " D. Cláudia colheu as rosas do último baile do ano, primeiro da República, e adornou a filha com elas," 
aformosear: " Abandonada essa área primitiva, foi reconstruída em lugar próximo por Herodes, que a aformoseou, preservando toda a sua grandeza históricas," 
ajaezar: " Caem-lhe sobre o dorso luzidio e negro os raios do Sol, ajaezando-a de lampejos," 
alfaiar: " Alfaiar a varanda com objetos rústicos," 
aparatar: " Aparatou a filha para o desfile," 
aparelhar: " Juno certamente as aparelhara com suas correias de ouro, freios de ouro, rédeas de ouro, tudo de ouro incorruptível," 
arrear1: " A menina arreava a boneca," 
ataviar: " José mesmo sendo um servo de Deus piedoso se ataviou com jóias que Faraó lhe presenteou ," 
colorir: " Desde cedo, o vermelho e o preto coloriram a cidade/A eleição mais disputada e emocionante do Rio Grande do Sul nos últimos tempos coloriu as ruas de Porto Alegre e das cidades do interior, envolvendo homens e mulheres, adultos e crianças," 
decorar1: " O carnaval de rua apenas se enfraquece com medidas como a de não decorar a Avenida Rio Branco/... decorei o palco com sete lâminas nas cores do arco-íris que serão iluminadas à medida que os convidados entrarem em cena," 
embelezar: " Foi o homem que embelezou muitas cidades brasileiras/Com grandes obras, como o Louvre, embeleza ainda mais Paris e estimula iniciativas culturais," 
emoldurar: " Paracelso emoldurou a Natureza com vistosas imagens, comparações acertadas, engenhosas alegorias e parábolas de sentido profundo," 
enfeitar: " Comprou vários peixes de diferentes espécies, e enfeitou o aquário com pedrinhas e plantas aquáticas, deixando-o bem bonito," 
enflorar: " ...enflorou com o seu feiticeiro sorriso os lábios," 
engalanar: " Brasil se engalanou para receber o presidente dos Estados Unidos, George Bush," 
exornar: " A afabilidade e a abnegação do sentimento refletem as conquistas éticas do ser, exornando-o com os louros da paz," 
florear: " Fawcett floreou além da conta a eficiente simplicidade da história," 
formosear: " O prefeito Renato Moreira a formoseou e ali fez erigir o primeiro monumento público," 
galantear: " Galanteia a filha com fitas e bordados," 
honestar: " onestava-se com a quase imperceptível maquiagem," 
moldurar: " A artista moldurou os selos com frisas ornamentais gregas nas partes superior e inferior, destacando, no centro da moldura inferior, os Arcos Olímpicos," 
ornamentar: " O mercado de Salvador começará a [ornamentar casas, hotéis e restaurantes com flores tropicais exóticas/o artista pintou a óleo e ornamentou as paredes do edifício," 
ornar: " Araci ouviu as palavras do guerreiro, palpitante como a corça; e ornou a fronte do esposo com o cocar de plumas vermelhas, que tecera em segredo/Nada mais natural que, da mesma forma que poderia escolher um boné de rapper ou de beisebol para [ornar sua cabeça, o garoto tenha desejado ganhar e usar um brinco," 
paramentar: " A mãe, Christiane Lima, 27 anos, paramentou a garotinha de baiana, com torso, contas e até uma miniatura dos jarros usados para carregar água-de-cheiro.," 
recamar: " Desde a porta da rua até à cozinha recamou-se o chão de folhas de mangueira e trevo cheiroso, pregaram-se arcos de verdura em todas as portas," 
revestir: " o capim gordura revestia de dourado os campos a partir de setembro," 
sazonar: " Sazonava de agradável humorismo a prosa," 
vestir: " O tecido que hoje é mais usado para panos de limpeza, vestia a casa de nossos avós," 
}
Alinhamento
  ILI: 01627899
  Synset: decorate, adorn, grace, ornament, embellish, beautify
  Glosa/Exemplo: make more attractive by adding ornament, colour, etc.; "Decorate the room for the party"; "beautify yourself for the special day" 
  Tipo Semantico: verb.creation

