Chave: CAUSAR
Glosa: dar origem
Tipo Semantico: verb.creation
{
acarrear: " A seca acarreou-lhe danos irreparáveis.," 
acarretar: " Sobretudo em crianças, a falta de vitamina A acarreta perda de peso e paralisação do crescimento. ," 
captar: " O Dr. Júlio captou a estima e consideração de todos os que tiveram ocasião de com ele praticar.," 
carrear: " No período que envolve a segunda década em estudo, a voraz remuneração das taxas de juros carreou volumes significativos de recursos para a especulação.," 
causar: " De acordo com o Snel, a reprodução ilegal causa prejuízo anual de US$ 100 milhões no Brasil. ," 
desencadear: " A luz é uma forma de energia, proveniente do espaço, que desencadeia a reação química de fotossíntese.," 
determinar: " Em lugar do multipartidarismo a nova legislação determinou o bipartidarismo.," 
ensejar: " A falta de pagamento ensejou a decretação de sua prisão civil em primeira instância.," 
germinar: " Julga que o acesso da terra a pequenos agricultores irá germinar em uma nova geração de novos empreendedores rurais, ajudando a erradicar a miséria do país. ," 
levantar: " A presença de 99 votos para Fortes em uma urna levantou suspeitas sobre a fraude.," 
motivar: " A reportagem motivou a formação de uma CEI (Comissão Especial de Inquérito).," 
ocasionar: " As guerras e as caçadas dos senhores afetavam diretamente os camponeses, pois muitas vezes ocasionavam a destruição das plantações. ," 
originar: " A limitação do orçamento originou um atrito entre o ministro da Fazenda, Rubens Ricupero, e o da Saúde, Henrique Santillo.," 
produzir: " A violência dos bailes funk produziu novas vítimas na madrugada de ontem.," 
promover: " O Relator promoveu profunda alteração no texto aprovado em Plenário, ao substituir a expressão "plano de carreira" por "planos de carreira"..  ," 
provocar: " A carência dessa vitamina provoca rachaduras e inflamações dos cantos da boca, inflamações da língua, intolerância à luz.," 
puxar: " O bom desempenho das indústrias automobilística e de autopeças puxou o consumo industrial de energia elétrica em São Paulo no mês passado . ," 
sugerir: " Este resultado sugeria a necessidade de um novo modo de pensar a respeito destes fenômenos perceptivos.," 
suscitar: " As interrogações que o empate técnico suscitou num país sempre atento ao que se passa fora de suas fronteiras ecoaram pelo resto do mundo.," 
trazer: " E isso traz conseqüências graves ao organismo.," 
}
Alinhamento
  ILI: 01598809
  Synset: cause, do2, make8
  Glosa/Exemplo: give rise to; cause to happen or occur, not always intentionally; "cause a commotion"; "make a stir"; "cause an accident" 
  Tipo Semantico: verb.creation

