Chave: ENFRAQUECER
Glosa: tornar fraco
Tipo Semantico: verb.change
{
alquebrar: " Os desgostos alquebraram-lhe as forças.," 
aquebrantar: " Uma falha do goleiro pode aquebrantar o seu ânimo, minar sua confiança.," 
cansar: " Ora, como tudo cansa, esta monotonia acabou por exaurir-me também.," 
debilitar: " Certos componentes da mentalidade farisaica traziam em si o germe do pecado, que debilitava o ser humano, inclinando-o para o mundanismo.," 
deprimir: " Os cientistas dizem que a droga também é capaz de deprimir o sistema imunológico.," 
derrear: " O divórcio derreou-o.," 
desnervar: " Descurou dos interesses do reino; e, a atuar sobre tudo, desservindo a nobres e a humildes, ameaçava desnervar a energia nacional.," 
desvigorar: " Penetra o coator no aparelho em que a vítima produz a vontade, desvigorando-o, por força da ameaça.," 
desvitalizar: " A contenda consome energia, desvitaliza e enfraquece.," 
elanguescer: " Ouço, ao ver-te andar, melódicos harpejos, que fazem mansamente amar e elanguescer.," 
enervar: " Ela enerva e desarruma o adversário.," 
enfraquecer: " O desejo desenfreado pela posse material enfraquece o espírito, sob o ponto de vista moral.," 
enlanguescer: " Porém, o suposto estado de calamidades em que se encontram vai gerando desdobramentos que fazem a alegria enlanguescer.," 
entibiar: " Entibiar o ânimo dos espíritas mais resolutos.," 
esgotar: " Tenho a impressão de que você está muito cansado, de que tudo isso o esgotou.," 
esmaecer: " Alguns percalços, é bem verdade, mais nada que pudesse esmaecer o nosso ânimo.," 
extenuar: " O rosário de argumentos nesse sentido que ele apresenta à mulher acaba por extenuá-la, a ponto de lhe pedir se pode lhe fazer um favor.," 
languescer: " Longe de me sentir desocupada, de languescer, diminuída por tanta nostalgia e apavorada diante do tempo a preencher.," 
prostrar: " Às vezes uma languidez invencível a prostrava.," 
quebrantar: " As luzes sinistramente amarelas dos círios e os sons plangentes do órgão impressionariam a delicada sensibilidade nervosa da afilhada e quebrantariam o seu ânimo altaneiro, predispondo-a para a confissão.," 
sopitar: " O homem cansado buscou a fonte generosa e refez-se com a linfa cristalina, abençoada; contemplando-a, tranqüila, não sopitou as emoções." 
}
Alinhamento
  ILI: 00377738
  Synset: enfeeble, debilitate, drain4
  Glosa/Exemplo: make weak; "Life in the camp drained him" 
  Tipo Semantico: verb.change

