Chave: CORAR
Glosa: tornar rosado ou avermelhado
Tipo Semantico: verb.change
{
abrasar: " E vergou profundamente os ombros, menos a saudá-la, que a esconder a tumultuosa onda de sangue que sentia abrasar-lhe o rosto.," 
acarminar: " Aquele folhetim acarminava as donzelas.," 
afoguear: " Senti a face afoguear e instantaneamente baixei o olhar. " " Não era para você! respondeu rápido o moço, baixando a cabeça de modo a ocultar o rubor que lhe afogueava o rosto.," 
afrontar: " O calor, afrontando-a, mais formosa a deixava.," 
avermelhar: " O Pedro avermelhou e olhou pros pés.," 
corar: " A afeição que tinha a Álvaro lhe parecia tão inocente, tão natural, que nunca se lembrara que devia um dia passar daquilo que era, isto é, de um prazer que fazia sorrir, e de um enleio que fazia corar.," 
enrubescer: " Não contentes com a sua vulgarização, fazem dela também uma imitação barata de Glenn Close com cenas de sexo de enrubescer por tão infelizes que são de imaginação.," 
envermelhecer: " Soltou uma gargalhada sonora que lhe balançou o ventre e envermelheceu mais.," 
erubescer: " E olhou para Hermione que sentiu sua face erubescer.," 
esbrasear: "  discussão esbraseou-lhe as faces.," 
esfoguear: " O calor fazia-o suar e esfogueava-lhe as faces.," 
foguear: " Com o rosto fogueando, arquejante, ela se levantou e sem dizer uma palavra saiu correndo.," 
incender: " ncende as faces, de rubor corando.," 
incendiar: " Um pubescente ansiar de abraços a de beijos incendeia-lhe a pele.," 
inflamar: " quelas palavras inflamaram-lhe o rosto.," 
rosar: " Concordou ele sem graça e sentindo o rosto rosar.," 
rosear: " Um pouco de sangue roseou a face de Maria.," 
rubificar: " A bofetada rubificou-lhe a face.," 
ruborescer: " São capazes de ruborescer até mesmo os mais habilidosos, engenhosos, perversos e criativos líderes do crime organizado.," 
ruborizar: " Parlamentares já admitem pasmem, sem sequer ruborizar que é muito difícil conseguir quorum para votação nesses dias.," 
tauxiar: " O sangue afluía-lhe às faces, tauxiando o rosto." 
}
Alinhamento
  ILI: 00280115
  Synset: blush1
  Glosa/Exemplo: become rosy or reddish; "her cheeks blushed in the cold winter air" 
  Tipo Semantico: verb.change

