Chave: OCULTAR
Glosa: tornar indecifrável ou imperceptível, encobrindo ou intervindo
Tipo Semantico: verb.change
{
abafar: " Afastado do Incra do Rio, por acusações de irregularidades, o superintendente Altamir Pettersen sobreviveu a uma comissão de investigação, abafou seus resultados e reassumiu o cargo com força total.," 
acobertar: " O manto da privatização acobertou o estelionato contra a Cosipa, ficando seus protagonistas livres de punição. ," 
calar1: " O dinheiro cala a verdade.," 
capear: " Com estes e muitos outros atentados, que por brevidade omito, se satisfizeram as exigências do marechal Barreto, de Pedro Chaves, e da facção retrógrada; mas era forçoso capear as perseguições com o manto da utilidade pública.," 
cobrir: " Um texto também pode ser um "vilarejo de Potemkin", onde a ficção cobre a verdade.," 
colorir: " pesar dos sofismas de que usou, não conseguiu colorir a sua grave falta.," 
contrafazer: " Quando o que há de essencial e específico na função parlamentar se omite ou se contrafaz, o espaço fica aberto para crises de todo gênero.," 
disfarçar: " No do PMDB, cujo candidato foi impugnado, o senador Gerson Camata mal disfarça suas simpatias por Fernando Henrique.," 
dissimular: " Seu estilo labiríntico de certa forma oculta ou dissimula opiniões heréticas.," 
encapotar: " Quis encapotar seus sentimentos.," 
encobertar: " Ao dizer que encobertou sujeiras no governo FHC , o presidente Luiz nácio Lula da Silva consegiu o que parecia quase impossível " 
encobrir: " A CA encobriu as conexões entre o rã ea Al-Qaeda.," 
envolver: " Envolveu sua tristeza em uma felicidade afetada.," 
esconder: " O delegado escondeu essa descoberta.," 
homiziar: " O índio Paraopeba, após a 2ª Batalha, fugiu e homiziou-se na serra biapaba, no Ceará, com seu bando.," 
mentir: " Na certidão de casamento, Gonzaga mentiu a idade.," 
ocultar: " festa dos meninos do Brasil amenizou a frustração de Senna, mas não ocultou sua preocupação. " " O escritor não ocultava sua aversão às multidões nos comícios.," 
omitir: " O presidente omitiu detalhes do projeto, mas não negou que a Umbro, patrocinadora do clube, é uma das empresas participantes.," 
reprimir: " Minha idéia é que a história dominante da arte moderna reprimiu várias coisas que ocorreram dentro dessa própria história. ," 
silenciar: " Aqui, a lei silencia sobre a natureza do ato judicial e, ao invés de utilizar o verbo «resolvendo», prefere dizer «decidindo», como a sugerir a existência de uma decisão interlocutória, por isso mesmo agravável.," 
solapar: " O crescimento do MDB após 1974 solapou o domínio arenista, provocando o racha conservador de 1984 (PDS/PFL) e a chegada do PMDB ao poder em 1985.," 
sonegar: " A empresa emitiu cheques sem fundos e sonegou informações ao BC. ," 
sufocar: " má prática das votações em assuntos científicos sufocou a verdade, derrotando a minoria defensora da boa causa," 
velar2: " Velou seus sentimentos para não ser desprezado.," 
}
Alinhamento
  ILI: 00304161
  Synset: obscure2, blot_out, obliterate1, veil, hide
  Glosa/Exemplo: make undecipherable or imperceptible by obscuring or concealing; "a hidden message"; "a veiled threat" 
  Tipo Semantico: verb.change

