Chave: PERAMBULAR
Glosa: andar sem um objetivo particular
Tipo Semantico: verb.motion
{
andar: " E começou a andar à toa.," 
andarilhar: " Saiu então a andarilhar pelas províncias em auxílio às vítimas da peste negra que assolava a Europa. " " Em pensar que um só homem o levaria a andarilhar sem rumo, sem meios e sem destino, até encontrar alguém.," 
arruar: " Um pajem que nos deixava gazear a escola, ir caçar ninhos de pássaros, ou simplesmente arruar, à toa, como dous peraltas sem emprego. ," 
bestar: " Fugir, pensava. Abandonar tudo aquilo e bestar por aí.," 
ciganear: " Meu ser coletivo revive quando lembro da celebração dos caretas que vivi e amei, quando ciganeava pelos interiores do Ceará.," 
deambular: " E em Poços também, como em outras cidades mineiras e paulistas, deambulam, num ritual silencioso, pintados de azul, os caiapós e seu auto da bugrinha raptada.," 
desvairar: " As nuvens, impelidas pelo vento, desvairavam-se pelos ares.," 
divagar: " A juruti, que divaga pela floresta, ouve o terno arrulho do companheiro; bate as asas, e voa a conchegar-se ao tépido ninho.," 
doidejar: " lta noite, doidejava pelas ruas ermas.," 
errar: " No hospital decadente erra por corredores à procura do médico, doutor Gotard.," 
flanar: " Nada como flanar na primavera/verão parisiense.," 
girar: " Outras ainda continuam indecisas entre girar pelo mundo ou permanecer paradas no porto seguro.," 
perambular: " Deixou a mulher, os nove filhos e passou a perambular pelas ruas, com as barbas crescidas.," 
pervagar: " Não é de se estranhar que, após pervagar durante anos por uma extensa porção de terra, Antônio Conselheiro tenha decidido se instalar com sua gente naquela região.," 
vagabundar: " Em vez de vagabundar pelas ruas, aprendem música, percussão, dança, fazem shows e encenações.," 
vagabundear: " Alguém já disse que, desde os tempos em que vagabundeavam pela terra, até mesmo depois que se empoleiraram no Olimpo, os deuses são medíocres.," 
vagamundear: " Errar é cometer erro ou engano, ou vagamundear sem rumo... a sós... ," 
vagar1: " É triste, como um cão velho, cego, silencioso, que parece vagar sem rumo.," 
vaguear: " Aos que não lhe podiam pagar, deixava-os vaguear durante cem anos pelas margens do Estige, antes de ingressarem no Inferno.," 
vaguejar: " Rotundos desenhos em terras claras a vaguejar, audazes, pela multidão.," 
zanzar: " Era como se ele nos desse uma carambola e nós, como bolhas de bilhar, ficássemos mentalmente a zanzar de um lado para o outro naquele quarto estreito." 
}
Alinhamento
  ILI: 01855163
  Synset: perambulate, walk_about, walk_around
  Glosa/Exemplo: walk with no particular goal; "we were walking around in the garden"; "after breakfast, she walked about in the park" 
  Tipo Semantico: verb.motion

