Chave: REPRIMIR
Glosa: manter sob controle
Tipo Semantico: verb.social
{
agrilhoar: " Agrilhoa o despotismo, e estanca os furores do povo indiscreto e volúvel.," 
amansar: " Disciplinou, moldou a alma humana, amansou a índole feroz dos bárbaros, arrancou raças inteiras à sensualidade ou à bestialidade," 
brecar: " sso brecou o amadurecimento da indústria de quadrinhos e inibiu sua criatividade por quase dez anos," 
bridar: " ...bridar uma emoção," 
coibir: " E isso coibiu bastante a ação dos marginais," 
comedir: " Até quando reclama ele comede suas atitudes," 
conter: " Leonardo lançou-lhe os olhos, e a custo conteve o riso," 
domar: " Talvéz por questão de pura sobrevivência, o homem domou seu gene primitivo, e aprendeu a conviver em sociedade," 
dominar: " A inteligência domina os instintos," 
embridar: " Embridar sentimentos reprováveis," 
enfrear: " Enfrear o gênio, os ímpetos," 
engolir: " Então engole o pranto e deixa o tempo apagar esta dor," 
frear: " Também o meu indicador freou algumas lágrimas que insistiram em rolar," 
frenar: " Um oficial graduado dos Bombeiros, ao encontrar sua mulher na companhia de um amante, não conseguindo frenar os ânimos do seu corroído ciúme, e, quando tentava sacar de uma arma, foi baleada por seu antagonista," 
medir: " Falava medindo os gestos e as palavras," 
moderar: " A temperança é virtude que deve presidir e moderar os gozos de todos os sentidos do homem," 
modicar: " Modicar os gastos," 
rebater: " É preciso rebater os impulsos violentos," 
refrear: " Sendo assim, desde segunda-feira o alto-tucanato trabalha no sentido de refrear ímpetos que no decorrer da campanha para a troca de comando no partido foram propositadamente estimulados/Para tanto, ele teria de refrear os seus instintos de piloto e manter suas mãos longe dos controles," 
reportar: " Reportar os instintos.," 
represar: " Joca Ramiro sabia represar os excessos," 
reprimir: " Foi ele o primeiro homem que declarou livre todo aquele capaz de, com sua razão, reprimir o ímpeto de suas próprias paixões/Loredano não pôde reprimir a risada sardônica que lhe veio aos lábios," 
sofrear: " No escritório, quando via Rubião assomar à porta, fazia um gesto de impaciência, que sofreava logo," 
sopear: " Leonardo ouviu tudo sem interromper, procurando sopear a raiva," 
sopitar: " Os contrastes não eram raros, nem os ímpetos, mas a lembrança da mãe estava tão fresca, a morte tão próxima, que eles sopitavam qualquer movimento, por mais que lhes custasse, e viviam unidos," 
suster: " Caetaninha não pôde suster o riso, quando o padrinho, expondo a matéria, perguntou-lhes se eles sabiam que existiam e por quê," 
temperar: " temperar os desejos/O homem maduro deve Atemperar as paixões," 
vencer: " Não te assustes, virgem das florestas; tua formosura venceu o ímpeto de meu braço e apagou a cólera no coração feroz do caçador," 
}
Alinhamento
  ILI: 02349665
  Synset: restrain1, suppress3, keep, keep_back, hold_back
  Glosa/Exemplo: keep under control; keep in check; "suppress a smile"; "Keep your temper"; "keep your cool" 
  Tipo Semantico: verb.social

