Chave: COMPELIR
Glosa: forçar ou compelir alguém a fazer algo
Tipo Semantico: verb.social
{
adscrever: " Contra esta projeção cristã que subordina o homem sob as previdências esotéricas do cristianismo, Feuerbach adscreveu a este a função de produção fantasmagórica do homem em busca de uma vida melhor, além de sua vida concreto-atual.," 
adstringir: " A hegemonia patriarcal adstringiu a mulher ao lar enquanto não interessava ao capitalismo sua mão-de-obra.," 
algemar: " A dívida não é um mal, desde que não vicie o devedor nem o algeme a prestações que nunca acabam.," 
amordaçar: " O estado de sítio propiciou a repressão e as leis para amordaçar a imprensa.," 
apertar: " O relator Osmar Serraglio apertou Henrique Pizzolato para que revelasse quem autorizou repasses de recursos da Visanet para a DNA.," 
asfixiar: " A sangrenta repressão política promovida pelo golpe de 1964 asfixiou o movimento popular pelo fechamento dos sindicatos e outras organizações de expressão.," 
cingir: " O que foi feito de nós, humanos, que nos cingiu o sentimento diante da dor de outro humano?," 
coagir: " Ele é acusado de ter coagido vários presos a atuar como cabos eleitorais.," 
compelir: " O século 19 compeliu muito seus homens de sucesso a montar imperiozinhos particulares.," 
constranger: " Os seus amigos rodearam-no e constrangeram-no a ficar.," 
contrafazer: " Contrafizeram-na a fazer uma denúncia contra o agressor.," 
dobrar: " Em 1983, eles dobraram a sisudez de um júri com a música “Um Estudo Muito Confuso” e abocanharam um sério 2º lugar.," 
forçar: " Nos últimos anos, as populações têm exigido do Estado brasileiro melhor qualidade e condições de vida, forçando-o a assumir responsabilidades que ultrapassam sua capacidade de atendimento.," 
impelir: " Camus insiste sobre as motivações profundas que impelem um homem a criar universos outros que não este.," 
maniatar: " Com tão nobre atitude maniatara os opositores.," 
manietar: " Só com o afastamento de Saddam Hussein o raque retomará seu destino de nação rica, interrompido pela megalomania de um ditador que manietou a população a serviço de objetivos pessoais.," 
obrigar: " Amin disse que primeiro o PT forçou Bisol a uma autocrítica, depois humilhou-o e, por fim, obrigou-o a renunciar.," 
pressionar: " A CBS pressionou Justin a se desculpar no Grammy.," 
reduzir: " Mas, se se amesquinhar o objetivo e reduzir-lo a deixar sadio o Estado e fortes as empresas, amesquinha-se também o resultado.," 
reprimir: " Reprimiu a razão.," 
urgir: " O PT foi bastante pusilânime e, até, omisso em relação à participação na Ação da Cidadania e ao próprio presidente Itamar, a quem urgiu assumir a tarefa de declarar guerra à fome e de iniciar a implantação da Política de Segurança Alimentar.," 
violentar: " A extrema miséria violentou-o a retirar-se daquela localidade com a maioria da população." 
}
Alinhamento
  ILI: 02431663
  Synset: compel, oblige, obligate
  Glosa/Exemplo: force or compel somebody to do something; "We compel all students to fill out this form" 
  Tipo Semantico: verb.social

