Chave: CORROMPER
Glosa: deturpar moralmente ou por intemperança ou por sensualidade
Tipo Semantico: verb.social
{
adulterar: " Adulterou seus hábitos saudáveis.," 
contaminar: " Contaminaram-no os piores vícios.," 
corromper: " O suborno corrompe o coração.," 
debochar: " As más companhias debocharam o pobre rapaz," 
depravar: " A ambição desmedida deprava as criaturas.," 
desencaminhar: " Desencaminhou os colegas dos estudos.," 
desgarrar: " Suas paixões o desgarravam dos preceitos evangélicos.," 
desgovernar: " O jogo e a bebida desgovernam os fracos de espírito.," 
desmoralizar: " Os economistas soviéticos desmoralizaram as teorias marxistas e, os brasileiros, todas as outras.," 
deturpar: " Enumerou vícios que deturpam a linguagem.," 
empestar: " Os maus exemplos empestaram seu comportamento.," 
esculhambar: " No final entendi porque tanta gente elogiou e porque tanta gente esculhambou o filme. ," 
extraviar: " á muitos apelos enganosos extraviando a juventude.," 
infeccionar: " Seu negativismo infeccionou toda uma geração.," 
infetar: " Tentaram infetar a população com aquela pestífera doutrina.," 
malignar: " Ambiente maligno, malignou o rapaz. ," 
perverter: " Esse rei pervertia outras pessoas, e perseguia os filhos de Deus, matando muita gente.," 
profligar: " A inveja profliga o ser humano.," 
prostituir: " A promiscuidade com o Executivo prostitui o Congresso.," 
subverter: " "Eu Tu Eles" entroniza desejo feminino no sertão machista, subverteu a moral.," 
ulcerar: " Ulcerou a moral das famílias.," 
viciar: " A fumaça viciou o ar.," 
}
Alinhamento
  ILI: 02502628
  Synset: 
  Glosa/Exemplo: corrupt morally or by intemperance or sensuality; "debauch the young people with wine and women"; "Socrates was accused of corrupting young men"; "Do school counselors subvert young children?"; "corrupt the morals" 
  Tipo Semantico: verb.social

