Chave: INCOMODAR
Glosa: causar incômodo ou desconforto
Tipo Semantico: verb.social
{
aborrecer: " A dor de dente aborrece muita gente.," 
amuar: " Barbosa amuou, resmungou, e creio que só a sua sensatez e bonomia de animal forte, o impediu de levar adiante a contenda.," 
aperrear: " Nesta versão usada no teste um problema na injeção eletrônica aperreou durante toda a viagem.," 
apoquentar: " Dona Carlota Joaquina apoquentava os vizinhos em Botafogo.," 
arreliar: " Taliesin arreliou-a dizendo que tinha conquistado um admirador, mas ela ignorou-os a ambos.," 
atormentar: " Novo horário atormenta madrugador e dorminhoco.," 
azucrinar: " Você azucrina seus vizinhos com sua ausência e desagrabilidade, você espanta seus amigos com reações que nem você mesmo conhecia em você.," 
causticar: " Causticou a platéia com palavrório infindável.," 
despeitar: " Mesmo morta, sua exuberância me despeitava.," 
encabular: " O homem rico em oratória encabulava pessoas de todos os tipos e as histórias brotavam soltas, ainda que fossem só de ouvido, sem que ninguém as tivesse presenciado.," 
encher: " Aquele rapaz enche.," 
enquizilar: " Eu sou um escritor difícil que a muita gente enquizila.," 
esquentar: " Simone, por sua vez, não esquenta com provocações desse tipo.," 
frigir: " A mãe frigiu-a até que confessasse seu erro.," 
importunar: " A esfinge tebana importunava os viajantes, propondo-lhes um enigma para decifrarem, depois devorava todos os que não podiam responder. ," 
incomodar: " A ausência de espaço incomoda o eletricista Antônio Maria da Silva. ," 
infernar: " Antes de Constantino assumir definitivamente o reinado em 323 d.C. ele infernou vários opositores. ," 
infernizar: " No Japão, o velhinho infernizou a vida de Jean Alesi pela terceira colocação.," 
irritar: " A atitude de Djalminha irritou o técnico, que ameaça até dispensá-lo do elenco.," 
judiar: " Judiava de minha mãe colocando bem alto os tangos de Gardel transmitidos pela rádio da cidade fronteiriça.," 
perseguir: " A campainha da porta a perseguia o dia inteiro.," 
quizilar: " O êxito do Torres quizilava-o.," 
torrar: " A CP do Mensalão consumiu R$ 5 milhões, torrou a paciência dos brasileiros durante quatro meses e teve um final patético.," 
zangar: " Esmagava flores inocentes, zangava a mulher, e, ao raiar do dia, assim sem mais nem menos, ia embora, desaparecia.," 
}
Alinhamento
  ILI: 02432863
  Synset: trouble, put_out, inconvenience1, disoblige, discommode, incommode, bother1
  Glosa/Exemplo: to cause inconvenience or discomfort to; "Sorry to trouble you, but..." 
  Tipo Semantico: verb.social

