Chave: DOMINAR
Glosa: estar no controle, dominar a guarda [de]
Tipo Semantico: verb.stative
{
amolgar: " Amolgou os políticos ao interesse do governador.," 
atrelar: " Era uma violação da vontade popular consagrada em 1988, centrada num modelo sócio-econômico no qual estão empenhados tantos quantos, sob o pretexto da globalidade, pretendem atrelar o Brasil aos interesses do neoliberalismo internacional.," 
avassalar: " Nada demais, aliás, num período em que a ciência - principalmente depois da segunda metade do século XIX - avassalava as mentes intelectuais.," 
coibir: " A boa educação os coibia a isso.," 
conquistar: " Na América Espanhola, depois de conquistarem e submeterem os primitivos habitantes, os espanhóis transportaram para a metrópole fabulosas quantidades ouro, prata e pedras preciosas, saqueadas dos astecas e maias.," 
debelar: " Aliou-se a Floriano Peixoto e, com ele no governo, forneceu recursos humanos e bélicos para debelar a revolução federalista e a revolta armada.," 
deslombar: " Deslombar um adversário.," 
dobrar: " Fernando Henrique dobrou a resistência do ministro José Serra, numa conversa à sós, no Alvorada, de sexta para sábado passado.," 
domar: " Ou seja, o capital vendeu aos futuristas a idéia de que na velocidade chegaríamos a conquistar a luta contra a morte e a domar a natureza, mas o progresso virou desastre e nos levou a ver que o tempo das coisas tem de ser ralentado ou o planeta se espatifa como uma supernova.," 
dominar: " Sete ladrões, vestidos com uniformes iguais aos dos trabalhadores da obra, dominaram os seguranças e roubaram o carro-forte.," 
expugnar: " Sobreveio ao Brasil nova esperança de expugnar com mais forças o inimigo.," 
forçar: " Mas foi ele que me fez entender o que é um verdadeiro pecado mortal" 
obrigar: " Sua nobreza é que obrigara o desafeto.," 
pisar: "  modéstia acaba pisando a arrogância.," 
prostrar: " Conheceram que podiam lutar corpo a corpo, a noite inteira, sem que um prostrasse o outro.," 
refrear: " Não existia a moral senão, justamente, para moderar os grandes e escudar os pequenos, refrear os opulentos e abrigar os pobres, conter os fortes e garantir os fracos.," 
sofrear: " Benedito foi ter com Maria Bárbara; e a moça ficou só na varanda, encostada à ombreira de uma porta a conter e reprimir nos soluços os ímpetos dos seus desejos violentados, como se sofreasse um bando de leões feridos.," 
subjugar: " Embora já descobertas anteriormente, a colonização efetiva das terras uruguaias só teve início em 1624, quando os espanhóis passaram a subjugar os índios Charrua que habitavam a área.," 
submeter: " As forças egípcias submeteram a Síria e a Palestina, atingiram o Eufrates, a Núbia e a Etiópia.," 
subordinar: " Se considerarmos a história da América Latina, vamos perceber que ela se fundou a partir de uma elite que escravizou negros e subordinou indígenas.," 
sujeitar: " Logo se domou o indômito, logo se sujeitou o rebelde, e da ovelha e do leão se fez uma parelha tão igual, qual a podia escolher a Mãe de Deus, para ela e seu Filho triunfarem dos homens. ," 
superar: " O primeiro mostra um chefe de guerra hermeticamente isolado na sua vontade de dominar, superar e aniquilar o inimigo - ao ponto de esquecer os riscos que correm sua própria vida e a dos seus jagunços.," 
ter: " Tinha nas mãos o assaltante.," 
torcer: " Era preciso torcer sua arrogância desde menino.," 
vencer: " Deixou-se vencer pela paixão.," 
vergar: " Parecia inacreditável que o poder da TV Globo ainda capaz de vergar alguns dos principais candidatos a presidente estivesse sendo vergado ele próprio.," 
vincular: " Preconceitos rançosos vinculavam e inibiam o rapaz." 
}
Alinhamento
  ILI: 02568359
  Synset: dominate1
  Glosa/Exemplo: be in control; rule the roost; "Her husband completely dominates her" 
  Tipo Semantico: verb.stative

