Chave: TORTURAR
Glosa: atormentar emocionalmente ou mentalmente
Tipo Semantico: verb.emotion
{
acanavear: " Os imperadores asiáticos acanaveavam os missionários.," 
aferroar: " Há anos uma dúvida aferroa os administradores de fundos de pensão.," 
afligir: " Mais um grande problema financeiro aflige o governo.," 
amarfanhar: " A fotografia de sua garota estampada na porta do guarda-roupas amarfanhava-o no coração.," 
amolestar: " A inércia como o frio me amolesta.," 
atormentar: " Este sonho atormenta Vidal Olmos durante anos.," 
atritar: " Evita atritar a família com seus problemas.," 
brutalizar: " Maomé brutalizava judeus mais de mil anos antes disto.," 
chagar: " Chagou o coração com preocupações.," 
cruciar: " nsólita inquietação cruciava-lhe o coração, como se funéreos pressentimentos o advertissem da aproximação de irremediáveis borrascas. ," 
crucificar: " A paixão crucifica a humanidade até hoje.," 
dilacerar: " A imagem de seu pai dilacerava seu coração e não desmarcava seus olhos.," 
espicaçar: " O ditador espicaçava demais os argentinos e brandia a possibilidade de uma guerra que, dessa vez, nem o papa evitaria.," 
excruciar: " A vida o excruciou desde a infância, com episódios que fariam a glória de qualquer psicanalista, surrealista ou cineasta.," 
exulcerar: " O desgosto exulcerou seu coração.," 
flagelar: " Esta lei evidentemente flagelava os mais pobres, os plebeus em geral.," 
lacerar: " A curiosidade o lacerava.," 
macerar: " Macerava-lhe, sobretudo, o espírito a fatalidade que resultava da catástrofe.," 
magoar: " Fui ser artista para ser feliz, achava que a vida nos magoa muito no dia-a-dia.," 
maltratar: " Diz-se que John Bobbitt, o desafortunado, maltratava a mulher.," 
martirizar: " Este tratamento martirizava-me; no quinto dia obtive que se suspendessem as malditas colheres de remédio que me estavam prostrando.," 
moer: " O abandono em que viviam as crianças moía seu coração.," 
molestar: " Apenas uma leve angina molestava a Cortázar que, hipocondríaco, tomava muitas as aspirinas.," 
mortificar: " A fome mortificava os operários.," 
remoer: " Um conflito interior remoía-lhe por dentro.," 
sangrar: " Sangrou-lhe o coração a saudade da Aurora.," 
seviciar: " O carrasco sevicia, humilha e administra a dor para arrancar uma informação, num sádico ritual que pode terminar com um cadáver em suas mãos.," 
supliciar: " Em 64, Nero supliciou os cristãos, acusando-os do incêndio de Roma.," 
torturar: " A pergunta o torturava, enquanto divagava pelos corredores da memória insubordinada.," 
tratear: " Tratear o espírito. Tratear os pensamentos.," 
}
Alinhamento
  ILI: 01750388
  Synset: torment, torture, excruciate, rack1
  Glosa/Exemplo: torment emotionally or mentally 
  Tipo Semantico: verb.emotion

