Chave: ENFURECER
Glosa: tornar furioso
Tipo Semantico: verb.emotion
{
abespinhar: " O massacre de 31 de março abespinhou as autoridades federais e estaduais porque foram trinta homicídios quase simultâneos.," 
aferar: " Um mínimo imprevisto aferava-o.," 
agastar: " A declaração agastou o chanceler Celso Amorim, que tenta fazer de conta que é o contrário.," 
aquecer: " Esse resultado aqueceu os ânimos da militância e vai isolando os que se opõem à estratégia, como os senadores José Sarney e Renan Calheiros.," 
arrebatar: " A provocação o arrebatou de modo assustador.," 
assanhar: " Uma manifestação do oráculo assanhou as pitonisas conservadoras brasileiras neste final de ano.," 
azedar: " Rubinho só azedou quando questionado sobre Michael Schumacher.," 
derrancar2: " A injúria o derrancou.," 
emborrascar: " Sua falta de pontualidade emborrasca o chefe.," 
embravecer: " O vereador João Dib embraveceu ontem, em meio ao impasse e decidiu renunciar a qualquer possibilidade de ser ele o presidente da Casa.," 
encolerizar: " Mas o seu destemido radicalismo encolerizou os que defendiam o princípio de deixar as coisas como sempre foram, e eles o crucificaram.," 
enervar: " A nova postura enervou o novato Carmelo Anthony, que se estranhou com o rival Raja Bell. ," 
enfezar: " A baixa qualidade da imagem nos enfezou o suficiente para pararmos de ver.," 
enfurecer: " Bento XV enfureceu muitos muçulmanos em setembro com um discurso que foi tomado como um insulto ao slã. ," 
enfuriar: " Nos anos 60, enquanto a revolução mundial socialista enfuriava Cuba, Vietnã, Camboja, a América Latina sentia o duro tacão de ditaduras apoiadas pelos USA.," 
enraivar: " Vai que um dia, de manhãzinha, ela falou uma palavra proibida, assim meio de sopetão, enraivando com algo.," 
enraivecer: " Um estado verdadeiramente organizado, inspirado nos ideais dos filósofos franceses, enraiveceu seus vizinhos, particularmente a czarina da Rússia.," 
escandecer: " A agressão covarde escandeceu a opinião pública.," 
espinhar: " Nossas brincadeiras espinhavam o pobre homem.," 
esquentar: "  acirrada disputa esquentou-o. ," 
estomagar: " Esse detalhe estomagou Bilac de tal forma que a farofa de miúdos do marreco engasgou-se-lhe na glote.," 
exaltar: " sso exaltou a população. ," 
exasperar: " A ingratidão da menina exasperou o dr. Sinfrônio.," 
excitar: " Excitou o irmão com provocações até fazê-lo brigar.," 
indignar: " O fato indignou os 11 irmãos, que, segundo o primeiro testamento, tinham direito a 50% dos bens de Senna. ," 
irar: " sto irou Shiva, que cortou a cabeça da criança. ," 
irritar: " Uma queda de energia na subestação Frei Caneca irritou os passageiros que procuravam fugir do trânsito na hora do rush.," 
picar: " A censura inoportuna picou seu ânimo.," 
revoltar: " A medida revoltou moradores, que chegaram a discutir rispidamente com os funcionários.," 
}
Alinhamento
  ILI: 01735048
  Synset: infuriate, exasperate1, incense1
  Glosa/Exemplo: make furious 
  Tipo Semantico: verb.emotion

