Chave: ENTRISTECER
Glosa: tornar infeliz
Tipo Semantico: verb.emotion
{
apunhalar: " A palavra covarde o apunhalava.," 
chocar1: " O crime chocou a população e foi encarado como um cerceamento à liberdade de imprensa.," 
compungir: " O sentimento de culpa que o impedia de dormir noites tranqüilas, desde que fora preso, compungia-o profundamente.," 
contristar: " O seu passamento, após longa e fecunda existência, contristou, sobremaneira, a todos que tiveram a felicidade de conhecê-lo.," 
desagradar: " É o dia de receber o perdão de Deus, por tudo que se tenha feito e que o desagradou.," 
embruscar: " Fundo ressentimento embruscava a jovem.," 
entristecer: " O que me entristeceu profundamente era algo que eu já sabia.," 
escandalizar: " O acinte escandalizou-o. ," 
estomagar: " As críticas, as perfídias o estomagaram.," 
ferir: " Se alguém o feriu no passado, a compaixão pode ser um bálsamo eficiente para auxiliar na cura.," 
flechar: " Flechou-o com injúrias.," 
machucar: " Perdão não significa esquecimento, significa deixar de dar importância àquilo que um dia nos machucou.," 
magoar: " Estou falando de alguém que magoou você de verdade.," 
mazelar: " ás notícias o mazelaram.," 
melancolizar: " E ainda me melancoliza mais estar imaginando que eles não conseguiram também erguer a cerca pra nós.," 
melindrar: " De acordo com os analistas de plantão, o discurso de Alfredo foi forte e melindrou os vereadores.," 
molestar: " olestou a colega falando rudemente.," 
ofender: " É claro que a pessoa que o ofendeu está errada, entretanto, isso não é motivo para ficarmos ressentidos.," 
susceptibilizar: " Também uma conversa não deverá provocar discussões sobre assuntos políticos, religiosos ou de qualquer natureza que possam de algum modo susceptibilizar algum dos presentes.," 
suscetibilizar: " Só por dever de honestidade, teria a observar que chamar a era em que estamos de vulgar poderia suscetibilizar seus amigos cristãos.," 
vulnerar: " O impacto da doença é medonho e limita o paciente, vulnerando-o física, moral, social e psicologicamente." 
}
Alinhamento
  ILI: 01760546
  Synset: sadden1
  Glosa/Exemplo: make unhappy; `The news of her death saddened me´ 
  Tipo Semantico: verb.emotion

