Chave: ALIVIAR
Glosa: diminuir a intensidade [de] ou acalmar
Tipo Semantico: verb.emotion
{
abaixar: " Vamos abaixar esses estados de exaltação.," 
abemolar: " Abemolou a voz quando o maestro entrou.," 
abrandar: " Ontem, em encontro com jornalistas estrangeiros, ele abrandou o tom de seu discurso.," 
acalentar: " Aí sentada à soleira, com a fronte nos joelhos esperou, até que o sono acalentou a dor em seu peito.," 
acalmar: " Jackie passou por ali e acalmou a situação.," 
adoçar: " Até o âncora Boris Casoy deixou-se adoçar pelos telefonemas do pefelista e já falava em “acusações pálidas” como justificativa da decisão. ," 
afrouxar: " As reflexões a seguir integram um conjunto de idéias cuja finalidade é afrouxar algumas tensões inconscientes que dificultam a conexão pessoal consigo mesmo.," 
aligeirar: " É dever de todos mitigar, suavizar e aligeirar, quanto possível, as angústias, misérias e dores desta vida que afligem os nossos irmãos.," 
aliviar: " O tratamento com analgésicos ou antiinflamatórios pode aliviar a dor.," 
amaciar: " Nem tudo são despesas na vida, e a glória das relações podia amaciar as agruras deste mundo.," 
amainar: " Nos anos 70, ele teve diversos problemas de saúde, sofreu com o sucesso de seu velho amigo Woody Allen e nem o seu próprio sucesso amainou suas neuroses.," 
amansar: " Homem deve saber amansar a vaidade.," 
ameigar: " Escondidos na folhagem os pássaros ameigavam o canto.," 
amenizar: " Para amenizar o problema, o Jardim Botânico do Rio iniciou estudo para o reflorestamento dos 40% de área degrada da reserva.," 
amolecer: " Apesar dos debates poderem se tornar brigas e inimizades, a prática do naven fortalece os laços afins e assim amolece a desarmonia da oposição na tribo.," 
amortecer: " Debate revela que o tempo amorteceu ódios e afetos criados em 64.," 
apagar: " O candidato tucano não conseguiu apagar os ressentimentos entre os dois partidos.," 
aplacar: " O poeta sem religião, e sem moral, é como o veneno derramado na fonte, onde morrem quantos aí procuram aplacar a sede.," 
aquebrantar: " Vencer, rasgando leis passadas, enfrentando trilhas falsas que confundem e levam a pesadelos, aquebrantando tabus para poder abrir o casulo da Esperança.," 
arrefecer: " As pesquisas divulgadas ontem arrefeceram o entusiasmo que Lula ensaiou nos últimos dias.," 
atenuar: " Exercícios respiratórios e de relaxamento atenuam as dificuldades da gestação e preparam o caminho para um trabalho de parto mais tranqüilo.," 
brandear: " O mar azul, levem-me a vê-lo sem demora, para que eu aprenda, desde cedo, que a violência deve se brandear em espumas.," 
calmar: " Outros métodos que ajudam a aliviar e calmar a dor são através do uso de técnicas de respiração padronizada, condicionamento verbal e relaxamento.," 
ceder: " A enfermidade começou a ceder. ," 
diluir: " O alto nível do espetáculo diluiu a indignação do público.," 
diminuir: " Isso não diminui em nada o medo, nem a angústia.," 
edulcorar: " Dir-se-ia que os deuses tiveram a bondade de misturá-los com os homens para edulcorar a tristeza da vida humana.," 
laxar: " Laxar os ânimos.," 
lenificar: " Mas lembro que o bom samaritano curou o homem ferido com vinho e azeite" 
lenir: " Não se pode acreditar que o prefeito esqueça as leis editadas no País para esposar a pieguice de movimentos político-demagógicos, ineptos e incapazes de lenir o suplício imposto pela Cohab-MG a centenas de mutuários carentes.," 
malear: " Maleando minhas atitudes, dissimulando alguns sentimentos.," 
minorar: " Os militares estavam desarmados, por se tratar de atividade de Ação Comunitária que visava a minorar o sofrimento da população atingida pelas chuvas.," 
mitigar: " A menina enlaçou-o com os braços, murmurando palavras entrecortadas de uma língua desconhecida; era talvez uma súplica, ou um consolo com que procurava mitigar a dor do vencido.," 
moderar: " Pedro moderava o tom e o sentido e acabava aceitando o regime republicano.," 
molificar: " No ocidente, as praias e vales areentos vão a pouco e pouco molificando o temperamento dos descendentes diretos dos "conquistadores".," 
quebrantar: " A encenação da missa, o esplendor dos altares e os sons plangentes do órgão impressionariam a delicada sensibilidade nervosa da afilhada e quebrantariam o seu ânimo altaneiro, predispondo-a para a confissão.," 
quebrar: " O passarinho há muito quebrava a tristeza de uma casa pobre.," 
reduzir: " Esse impacto é distribuído igualmente por todo o pé, reduzindo a dor e o desconforto.," 
refrigerar: " Se Sagitário e Peixes esperam alcançar a serenidade juntos, precisarão refrigerar a tensão quando esta começa a subir.," 
remitir: " Ela está sem crises e a sua psicose remitiu.," 
retundir: " Retundir a indignação.," 
suavizar: " Finalmente alguma coisa para suavizar um pouco a tristeza do jovem Yarlen.," 
temperar: " É sempre bom temperar as expectativas, evitando a ilusão de se perseguir uma “inflação zero”." 
}
Alinhamento
  ILI: 01762368
  Synset: still1, allay, relieve, ease
  Glosa/Exemplo: lessen the intensity of or calm; "The news eased my conscience"; "still the fears" 
  Tipo Semantico: verb.emotion

