Chave: APOQUENTAR
Glosa: perturbar a tranqüilidade [de]; afligir com agitação mental ou angústia
Tipo Semantico: verb.emotion
{
acabrunhar: " Agora é tarde, e o meu pungente arrependimento não me aproveita, e só duplica a aflição que me acabrunha.," 
acossar: " Uma dúvida acossou Moacir.," 
afligir: " Com os olhos em mim, Capitu queria saber que notícia era a que me afligia tanto .," 
agoniar: " Procurei me lembrar de tantas vezes na minha vida em que agi desse modo vivendo um momento e pensando em outro, me agoniando com coisas que tinham dia e hora certos para serem vividas .," 
amofinar: " quela preocupação amofinava-o, consumia-o. ," 
angustiar: " Um grande problema angustiava os grandes senhores de todo o Brasil.," 
ansiar: " Ansiava-o a idéia de perdê-la.," 
apoquentar: " Esta idéia apoquentava-me há algumas semanas.," 
atormentar: " Uma esperança que lhe fugia, que a atormentava.," 
cauterizar: " A ascensão do ateu cauterizava o coração simples dos crentes.," 
comprimir: " Temores terríveis comprimiam-lhe o ânimo.," 
confranger: " Aquela grande miséria confrangia a alma de todos.," 
contristar: " A indiferença dos parentes contristou-o.," 
desolar: " A morte do Getúlio Vargas desolou toda a nação.," 
lancinar: " E a dor da brutalidade daqueles maltratos que lancinava a alma.," 
morder: " Os acontecimentos funestos mordiam-no.," 
oprimir: " Jamais o problema da vida e da morte me oprimira o cérebro.," 
pungir: " Caminhava a passo lento e frouxo com a cabeça descaída, revolvendo na mente reminiscências que lhe pungiam o coração.," 
ralar: " Ralar a alma. ," 
torturar: " Lembranças que fortalecem a saudade e torturam meu coração.," 
verrumar: " O ciúme verrumou-lhe o coração.," 
vexar: " O seu olhar terrível, cheio de nobre desprezo, humilha-me, e a sua indiferença vexa-me.," 
}
Alinhamento
  ILI: 01714958
  Synset: worry1, vex2
  Glosa/Exemplo: disturb the peace of mind of; afflict with mental agitation or distress; "I cannot sleep--my daughter´s health is worrying me" 
  Tipo Semantico: verb.emotion

